Town,County,Bus,Motorcycle,Other,Rail,Car,Bicyle / On Foot,Total,Cluster
Abbeydorney,Kerry,68,0,2,2,604,54,730,0
Abbeyfeale,Limerick,64,2,10,2,1840,476,2394,0
Abbeyknockmoy,Galway,76,0,2,0,378,18,474,0
Abbeyleix,Laois,258,4,6,46,1560,304,2178,0
Adamstown,Wexford,10,0,0,0,262,78,350,0
Adare,Limerick,106,0,8,4,1094,262,1474,0
Aghada-Rostellan,Cork,168,2,0,14,1098,100,1382,0
Aglish,Waterford,50,2,2,0,272,52,378,0
Ahascragh,Galway,12,0,6,2,154,8,182,0
Ailt An Chorráin,Donegal,30,0,0,0,204,32,266,0
Allenwood,Kildare,246,8,24,20,1784,168,2250,0
An Bun Beag,Donegal,46,0,6,0,670,90,812,0
An Charraig,Donegal,18,0,2,2,286,62,370,0
An Cheathrú Rua,Galway,30,0,2,2,486,120,640,0
An Clochán Liath,Donegal,44,4,4,4,942,220,1218,0
An Fál Carrach,Donegal,44,0,6,0,512,196,758,0
An Rinn,Waterford,30,0,2,2,686,126,846,0
An Spidéal,Galway,10,0,0,0,242,70,322,0
Anagaire,Donegal,50,0,2,0,220,40,312,0
Annacotty,Limerick,204,2,10,0,3040,956,4212,0
Annagassan,Louth,32,0,2,0,178,16,228,0
Annaghdown,Galway,26,0,2,0,230,2,260,0
Annascaul,Kerry,60,0,0,0,246,38,344,0
Annayalla,Monaghan,34,0,2,0,238,42,316,0
Ardagh,Limerick,18,0,6,0,268,30,322,0
Ardara,Donegal,106,0,0,0,582,160,848,0
Ardee,Louth,366,4,20,12,4234,1684,6320,0
Ardfert,Kerry,72,0,4,0,706,88,870,0
Ardfinnan,Tipperary,140,2,2,2,954,84,1184,0
Ardmore,Waterford,54,2,0,2,314,126,498,0
Ardnacrusha,Clare,82,0,4,2,1564,50,1702,0
Arklow,Wicklow,648,26,34,176,11320,3708,15912,3
Arthurstown,Wexford,6,0,4,0,116,14,140,0
Arvagh,Cavan,38,0,12,2,348,112,512,0
Ashbourne,Meath,2090,84,36,48,13612,5782,21652,3
Ashford,Wicklow,216,8,4,30,1772,198,2228,0
Askeaton,Limerick,46,0,4,2,912,312,1276,0
Athboy,Meath,328,6,10,8,2190,664,3206,0
Athea,Limerick,52,0,6,0,320,80,458,0
Athenry,Galway,146,10,4,262,4528,1140,6090,0
Athgarvan,Kildare,72,4,6,68,1416,142,1708,0
Athleague,Roscommon,44,0,0,2,304,44,394,0
Athlone,Westmeath,2472,36,70,402,17500,5184,25664,3
Athy,Kildare,828,30,40,600,8744,2652,12894,0
Aughnacliffe,Longford,26,0,2,2,160,18,208,0
Aughrim,Wicklow,308,4,6,16,1226,194,1754,0
Avoca,Wicklow,116,4,8,20,600,128,876,0
Baile Chláir,Galway,126,8,0,4,1570,546,2254,0
Baile Mhic Íre,Cork,18,0,4,0,336,112,470,0
Bailieborough,Cavan,158,2,18,2,2324,572,3076,0
Balbriggan,Dublin,2650,76,60,2694,17318,8868,31666,3
Balla,Mayo,26,0,10,0,926,154,1116,0
Ballaghaderreen,Roscommon,112,2,20,16,1548,670,2368,0
Ballina,Mayo,1102,8,26,16,8734,2158,12044,0
Ballina,Tipperary,170,4,8,16,2732,988,3918,0
Ballinabrannagh,Carlow,68,0,12,12,610,136,838,0
Ballinaclash,Wicklow,82,0,4,12,280,2,380,0
Ballinagar,Offaly,38,0,2,0,354,46,440,0
Ballinagh,Cavan,180,0,4,2,904,160,1250,0
Ballinakill,Laois,10,0,6,6,454,54,530,0
Ballinalack,Westmeath,26,0,2,2,164,14,208,0
Ballinalee,Longford,52,0,4,8,346,34,444,0
Ballinameen,Roscommon,24,0,4,0,296,2,326,0
Ballinamore,Leitrim,58,0,8,4,844,292,1206,0
Ballinasloe,Galway,356,12,36,116,4994,1272,6786,0
Ballincar,Sligo,16,0,2,0,312,24,354,0
Ballinderreen,Galway,56,0,2,2,390,108,558,0
Ballindine,Mayo,50,0,4,0,438,68,560,0
Ballindrait,Donegal,8,0,2,0,70,4,84,0
Ballineen-Enniskean,Cork,98,0,6,0,556,140,800,0
Ballingarry,Limerick,58,0,2,0,614,102,776,0
Ballingarry,Tipperary,22,0,2,8,218,40,290,0
Ballinlough,Roscommon,12,0,4,0,308,28,352,0
Ballinroad,Waterford,40,2,8,0,1810,160,2020,0
Ballinrobe,Mayo,172,4,16,6,2650,836,3684,0
Ballinspittle,Cork,58,0,0,0,330,74,462,0
Ballintober,Roscommon,8,0,2,2,206,20,238,0
Ballintogher,Sligo,60,0,4,0,392,48,504,0
Ballintra,Donegal,20,0,0,0,226,14,260,0
Ballitore,Kildare,82,0,0,6,644,30,762,0
Ballivor,Meath,370,0,6,14,1826,326,2542,0
Ballon,Carlow,128,2,0,4,702,192,1028,0
Ballyagran,Limerick,14,0,2,0,180,10,206,0
Ballybay,Monaghan,62,0,14,2,1226,340,1644,0
Ballybofey-Stranorlar,Donegal,662,4,36,4,4648,762,6116,0
Ballyboghil,Dublin,94,6,4,32,804,162,1102,0
Ballybrittas,Laois,60,2,2,14,518,16,612,0
Ballybunion,Kerry,34,0,2,10,1234,276,1556,0
Ballycanew,Wexford,76,0,6,6,526,90,704,0
Ballycannan,Clare,30,4,2,0,708,12,756,0
Ballycastle,Mayo,22,0,0,0,150,20,192,0
Ballyclerahan,Tipperary,58,2,10,2,1092,118,1282,0
Ballyclogh,Cork,42,0,6,2,276,44,370,0
Ballycolla,Laois,4,0,0,0,136,6,146,0
Ballyconnell,Cavan,206,12,10,4,1132,350,1714,0
Ballycotton,Cork,38,0,0,0,426,72,536,0
Ballycullane,Wexford,30,0,2,2,182,34,250,0
Ballycumber,Offaly,16,0,0,0,214,18,248,0
Ballydehob,Cork,22,0,4,0,222,58,306,0
Ballydesmond,Cork,18,2,12,0,228,28,288,0
Ballyduff,Kerry,74,2,0,0,340,62,478,0
Ballyforan,Roscommon,28,0,0,0,184,50,262,0
Ballygar,Galway,34,2,2,2,554,192,786,0
Ballygarvan,Cork,82,0,4,0,626,114,826,0
Ballygawley,Sligo,36,0,0,2,356,8,402,0
Ballyhack,Wexford,12,0,0,0,154,32,198,0
Ballyhahill,Limerick,24,0,2,0,120,34,180,0
Ballyhaise,Cavan,124,0,4,2,692,172,994,0
Ballyhale,Kilkenny,6,0,2,0,182,40,230,0
Ballyhaunis,Mayo,180,2,12,26,1724,950,2894,0
Ballyheigue,Kerry,120,0,2,4,378,42,546,0
Ballyhogue,Wexford,60,0,0,0,252,22,334,0
Ballyhooly,Cork,80,0,0,0,606,124,810,0
Ballyjamesduff,Cavan,164,2,16,4,2534,1082,3802,0
Ballyknockan,Wicklow,56,0,0,0,238,6,300,0
Ballylanders,Limerick,36,0,2,0,266,88,392,0
Ballyliffin,Donegal,82,0,2,0,374,46,504,0
Ballylinan,Laois,206,2,12,32,1176,148,1576,0
Ballylongford,Kerry,66,0,4,0,354,18,442,0
Ballymacarbry,Waterford,24,0,0,0,138,14,176,0
Ballymacoda,Cork,62,2,0,0,218,0,282,0
Ballymahon,Longford,40,2,2,6,1162,524,1736,0
Ballymore,Westmeath,64,0,8,8,500,50,630,0
Ballymore Eustace,Kildare,112,0,0,12,600,92,816,0
Ballymote,Sligo,98,4,4,18,1534,364,2022,0
Ballymurn,Wexford,84,2,2,2,690,78,858,0
Ballynacargy,Westmeath,28,0,0,0,128,48,204,0
Ballynacarrow,Sligo,18,0,0,0,256,28,302,0
Ballyneety,Limerick,36,0,0,2,682,18,738,0
Ballynoe,Cork,50,0,0,0,208,6,264,0
Ballyoulster,Kildare,80,2,2,10,336,60,490,0
Ballyporeen,Tipperary,42,0,4,2,252,60,360,0
Ballyragget,Kilkenny,148,0,10,4,952,188,1302,0
Ballyroan,Laois,102,0,6,4,712,64,888,0
Ballyroe,Kildare,24,0,2,4,160,36,226,0
Ballysadare,Sligo,88,4,10,10,2012,272,2396,0
Ballyshannon,Donegal,124,2,4,6,1626,514,2276,0
Ballysimon,Wexford,32,0,12,0,356,40,440,0
Ballyvaughan,Clare,34,0,2,0,94,48,178,0
Balrothery,Dublin,380,10,4,84,2030,498,3006,0
Baltimore,Cork,86,2,8,4,272,90,462,0
Baltinglass,Wicklow,104,4,8,12,2014,774,2916,0
Baltray,Louth,10,0,0,4,166,2,182,0
Banagher,Offaly,62,0,12,6,1372,586,2038,0
Bandon,Cork,808,18,44,18,7458,1716,10062,0
Bangor Erris,Mayo,50,0,4,0,266,70,390,0
Bansha,Tipperary,42,0,0,6,256,62,366,0
Banteer,Cork,36,0,2,10,312,50,410,0
Bantry,Cork,102,2,12,2,2240,780,3138,0
Barndarrig,Wicklow,54,0,2,2,256,10,324,0
Barntown,Wexford,34,0,0,4,526,26,590,0
Baylin,Westmeath,14,0,0,6,340,26,386,0
Bearna,Galway,144,8,10,8,2436,362,2968,0
Beaufort,Kerry,26,0,2,2,280,18,328,0
Beaulieu,Louth,12,2,6,4,230,12,266,0
Belcarra,Mayo,12,0,0,0,180,36,228,0
Belgooly,Cork,206,0,2,6,888,140,1242,0
Bellanagare,Roscommon,12,0,4,0,124,14,154,0
Bellanode,Monaghan,64,0,2,0,484,22,572,0
Bellavary,Mayo,20,0,0,0,186,34,240,0
Belmont,Offaly,12,0,0,0,152,14,178,0
Belturbet,Cavan,120,0,4,6,1154,306,1590,0
Bennettsbridge,Kilkenny,72,0,8,2,600,100,782,0
Birr,Offaly,152,2,24,36,3602,1314,5130,0
Blacklion,Cavan,8,0,0,4,162,22,196,0
Blackwater,Wexford,60,0,0,2,390,62,514,0
Blarney,Cork,198,4,2,8,2798,370,3380,0
Blessington,Wicklow,808,20,16,52,5150,1570,7616,0
Boherbue,Cork,8,0,0,0,406,118,532,0
Boherlahan,Tipperary,16,0,2,4,170,20,212,0
Bohola,Mayo,26,0,0,0,170,10,206,0
Bonniconlon,Mayo,12,0,0,0,204,36,252,0
Borris,Carlow,20,0,4,6,438,164,632,0
Borris-In-Ossory,Laois,104,0,4,6,538,124,776,0
Borrisokane,Tipperary,62,6,2,0,808,330,1208,0
Borrisoleigh,Tipperary,12,2,12,8,662,134,830,0
Boyle,Roscommon,136,0,14,20,1886,684,2740,0
Bracknagh,Offaly,28,0,4,4,238,16,290,0
Brannockstown,Kildare,8,4,2,10,254,10,288,0
Bray,Wicklow,4460,170,114,3360,22580,8834,39518,3
Bree,Wexford,34,0,0,2,318,58,412,0
Bridebridge,Cork,24,2,4,0,204,28,262,0
Bridge End,Donegal,50,0,4,0,360,52,466,0
Bridgetown,Wexford,80,0,0,0,446,92,618,0
Brittas,Dublin,26,0,2,4,168,2,202,0
Broadford,Clare,36,0,4,0,328,56,424,0
Broadford,Limerick,12,0,2,0,194,48,256,0
Brosna,Kerry,16,0,0,0,130,14,160,0
Bruff,Limerick,106,0,8,4,756,172,1046,0
Bruree,Limerick,62,0,4,0,600,56,722,0
Bun Na Leaca,Donegal,148,0,0,0,422,26,596,0
Bunclody,Wexford,52,2,4,12,1474,456,2000,0
Buncrana,Donegal,374,0,48,4,6672,1124,8222,0
Bundoran,Donegal,122,2,6,12,1906,720,2768,0
Bunratty,Clare,36,2,0,2,338,12,390,0
Burnfoot,Donegal,92,0,6,0,378,10,486,0
Butlersbridge,Cavan,20,0,4,0,260,46,330,0
Buttevant,Cork,52,2,2,8,836,208,1108,0
Bweeng,Cork,96,0,4,2,908,82,1092,0
Béal An Mhuirthead,Mayo,50,0,4,2,854,274,1184,0
Béal Átha An Ghaorthaidh,Cork,2,0,0,0,246,46,294,0
Caherconlish,Limerick,236,0,2,2,1498,180,1918,0
Cahir,Tipperary,308,2,12,20,2970,832,4144,0
Cahirciveen,Kerry,56,2,2,2,672,372,1106,0
Callan,Kilkenny,182,4,6,8,2396,656,3252,0
Calverstown,Kildare,132,0,2,28,760,20,942,0
Camolin,Wexford,66,4,10,0,352,64,496,0
Campile,Wexford,114,0,2,0,262,12,390,0
Cappamore,Limerick,80,6,6,0,470,166,728,0
Cappawhite,Tipperary,36,0,0,4,334,78,452,0
Cappoquin,Waterford,116,0,4,0,566,162,848,0
Carlanstown,Meath,94,2,6,0,826,138,1066,0
Carlingford,Louth,174,2,4,10,1120,268,1578,0
Carlow,Carlow,1208,122,114,478,22762,7268,31952,3
Carndonagh,Donegal,204,0,22,4,2462,456,3148,0
Carnew,Wicklow,32,0,4,10,908,400,1354,0
Carney,Sligo,118,0,2,4,458,12,594,0
Carragh,Kildare,188,0,0,92,1018,220,1518,0
Carraig Airt,Donegal,54,0,0,0,204,26,284,0
Carrick-On-Shannon,Leitrim,176,10,14,54,4310,1096,5660,0
Carrick-on-Suir,Tipperary,584,6,6,14,4312,1232,6154,0
Carrickmacross,Monaghan,482,8,38,2,4738,1574,6842,0
Carrig on Bannow,Wexford,84,0,2,0,322,50,458,0
Carrigaline,Cork,1796,58,64,26,20048,3152,25144,3
Carrigallen,Leitrim,10,0,0,6,426,144,586,0
Carrigans,Donegal,54,0,2,2,374,18,450,0
Carrigkerry,Limerick,26,0,0,0,154,20,200,0
Carrignavar,Cork,4,0,2,4,636,114,760,0
Carrigtwohill,Cork,396,32,12,186,5990,1530,8146,0
Carrowkeel,Donegal,62,0,0,0,274,68,404,0
Cashel,Tipperary,166,4,20,22,3842,1466,5520,0
Castlebar,Mayo,460,12,46,52,11318,3494,15382,3
Castlebellingham-Kilsaran,Louth,150,6,4,8,962,134,1264,0
Castleblayney,Monaghan,178,6,24,10,3394,1050,4662,0
Castlebridge,Wexford,176,6,4,6,1956,250,2398,0
Castlecomer,Kilkenny,66,2,0,6,1230,328,1632,0
Castleconnell,Limerick,350,8,18,16,2466,320,3178,0
Castledermot,Kildare,62,0,16,18,1506,450,2052,0
Castlefinn,Donegal,152,0,8,2,514,104,780,0
Castlegregory,Kerry,12,2,4,2,352,62,434,0
Castleisland,Kerry,84,0,16,4,2208,476,2788,0
Castlelyons,Cork,70,0,0,0,484,14,568,0
Castlemagner,Cork,42,0,8,6,452,2,510,0
Castlemaine,Kerry,6,0,2,0,184,12,204,0
Castlemartyr,Cork,286,4,10,6,1402,390,2098,0
Castlepollard,Westmeath,56,0,6,4,1052,310,1428,0
Castlerea,Roscommon,104,6,22,38,1510,336,2016,0
Castletown,Laois,46,0,2,4,422,70,544,0
Castletown Geoghegan,Westmeath,38,0,2,4,274,30,348,0
Castletownbere,Cork,12,0,4,0,756,384,1156,0
Castletownroche,Cork,40,0,6,4,384,114,548,0
Castletownshend,Cork,6,0,2,2,126,14,150,0
Causeway,Kerry,2,0,2,0,184,30,218,0
Cavan,Cavan,846,20,48,26,10680,2234,13854,3
Celbridge,Kildare,3912,124,34,892,16910,5594,27466,3
Charlestown-Bellahy,Mayo,54,0,12,2,1072,322,1462,0
Charleville,Cork,182,10,16,12,3144,968,4332,0
Cheekpoint,Waterford,20,0,6,4,242,10,282,0
Churchtown,Cork,60,0,0,16,570,162,808,0
Cill Charthaigh,Donegal,54,0,2,0,344,50,450,0
Cill Rónáin,Galway,16,0,4,2,114,96,232,0
Clane,Kildare,946,24,18,178,7760,2064,10990,0
Clara,Offaly,184,4,14,80,3092,654,4028,0
Claremorris,Mayo,474,16,6,26,3320,736,4578,0
Clarina,Limerick,42,0,2,0,682,36,762,0
Clarinbridge,Galway,112,0,4,8,994,88,1206,0
Clashmore,Waterford,54,2,0,0,256,46,358,0
Clifden,Galway,64,0,6,6,712,504,1292,0
Cliffony,Sligo,52,2,6,0,454,58,572,0
Clogh,Kilkenny,42,0,4,2,274,14,336,0
Cloghan,Offaly,76,0,8,2,590,74,750,0
Clogheen,Tipperary,60,4,0,0,418,62,544,0
Clogherhead,Louth,482,2,22,36,2056,518,3116,0
Cloghfin,Donegal,20,0,0,0,120,4,144,0
Clonakilty,Cork,204,10,12,8,4000,1796,6030,0
Clonard,Meath,78,2,2,6,326,24,438,0
Clonaslee,Laois,20,2,4,4,632,84,746,0
Clonbullogue,Offaly,46,2,2,6,314,58,428,0
Clondrohid,Cork,22,0,2,0,212,18,254,0
Clondulane,Cork,4,2,2,0,554,96,658,0
Clonee,Meath,200,16,2,48,1060,200,1526,0
Clonegall,Carlow,10,0,6,0,202,60,278,0
Clones,Monaghan,72,2,10,4,1258,818,2164,0
Clongeen,Wexford,46,0,0,2,212,22,282,0
Clonlara,Clare,52,0,4,2,840,118,1016,0
Clonmany,Donegal,104,0,6,2,438,58,608,0
Clonmel,Tipperary,756,50,46,32,16448,3590,20922,3
Clonmellon,Westmeath,102,0,8,4,670,136,920,0
Clonroche,Wexford,30,0,0,0,212,62,304,0
Clontibret,Monaghan,40,0,0,2,216,32,290,0
Clonygowan,Offaly,32,0,4,20,306,74,436,0
Cloonfad,Roscommon,26,0,6,0,378,70,480,0
Cloontuskert,Roscommon,10,2,0,2,180,16,210,0
Cloughduv,Cork,68,0,2,0,450,88,608,0
Cloughjordan,Tipperary,128,2,8,14,392,228,772,0
Cloyne,Cork,306,12,12,30,1926,388,2674,0
Cluain Bú,Galway,88,0,4,0,498,8,598,0
Coachford,Cork,12,0,2,0,416,140,570,0
Cobh,Cork,1398,30,116,606,12322,3338,17810,3
Coill Dubh (Blackwood),Kildare,234,6,4,10,1402,198,1854,0
Collinstown,Westmeath,36,2,0,0,304,66,408,0
Collon,Louth,242,0,2,4,732,188,1168,0
Collooney,Sligo,146,0,2,12,1894,346,2400,0
Conna,Cork,118,0,4,0,542,96,760,0
Convoy,Donegal,196,0,6,0,1484,182,1868,0
Coolaney,Sligo,164,4,6,6,1478,42,1700,0
Coolboy,Wicklow,54,0,2,0,314,6,376,0
Coolgreany,Wexford,30,4,6,4,356,40,440,0
Cootehall,Roscommon,52,2,4,2,300,2,362,0
Cootehill,Cavan,234,0,6,2,1564,416,2222,0
Cork city and suburbs,Cork,25718,868,648,1218,170530,59804,258786,4
Corofin,Clare,158,0,0,2,676,76,912,0
Corrandulla,Galway,70,2,0,0,400,74,546,0
Corrofin,Galway,158,0,4,2,906,14,1084,0
Courtbrack,Cork,26,0,4,0,676,0,706,0
Courtmacsherry,Cork,118,0,2,2,508,38,668,0
Courtown,Wexford,676,4,22,28,3416,548,4694,0
Cratloe,Clare,52,4,4,2,910,44,1016,0
Craughwell,Galway,162,0,6,10,1250,38,1466,0
Creeslough,Donegal,64,0,0,0,266,68,398,0
Crinkill,Offaly,28,0,0,6,728,158,920,0
Cromane,Kerry,4,0,0,0,222,16,242,0
Crookstown,Cork,32,0,0,0,194,8,234,0
Croom,Limerick,26,2,0,0,658,266,952,0
Crossakeel,Meath,30,0,0,2,230,8,270,0
Crossbarry,Cork,156,0,4,0,434,4,598,0
Crosshaven,Cork,222,10,12,6,3290,610,4150,0
Crossmolina,Mayo,24,2,4,0,1126,166,1322,0
Crusheen,Clare,60,2,2,4,786,88,942,0
Culdaff,Donegal,54,2,2,2,352,24,436,0
Curragh Camp,Kildare,126,6,4,18,974,102,1230,0
Cut Bush,Kildare,48,0,2,12,306,58,426,0
Daingean,Offaly,182,4,10,22,1048,198,1464,0
Delvin,Westmeath,134,2,4,6,608,62,816,0
Derrinturn,Kildare,402,0,10,18,1638,346,2414,0
Dingle-Daingean Uí Chuis,Kerry,42,8,8,12,804,718,1592,0
Doirí Beaga,Donegal,52,0,6,0,622,72,752,0
Donabate,Dublin,812,40,18,2780,6622,3226,13498,0
Donard,Wicklow,24,0,2,0,204,48,278,0
Donaskeigh,Tipperary,18,0,4,0,188,10,220,0
Donegal,Donegal,84,6,14,2,2324,524,2954,0
Doneraile,Cork,14,2,2,8,742,178,946,0
Donore,Meath,140,2,0,10,698,178,1028,0
Doohamlat,Monaghan,32,0,0,0,292,64,388,0
Doon,Limerick,16,2,8,2,600,164,792,0
Doonbeg,Clare,22,0,2,0,182,60,266,0
Drangan,Tipperary,8,0,4,0,132,10,154,0
Drimoleague,Cork,48,0,2,0,438,68,556,0
Drogheda,Louth,6686,136,126,1208,31176,13690,53022,3
Dromahair,Leitrim,90,2,0,0,964,178,1234,0
Dromina,Cork,14,0,2,0,298,44,358,0
Dromineer,Tipperary,0,0,0,0,80,6,86,0
Dromiskin,Louth,188,4,2,8,1318,150,1670,0
Drommahane,Cork,78,2,10,18,960,196,1264,0
Dromore West,Sligo,70,0,4,0,270,20,364,0
Drumcollogher,Limerick,4,0,8,2,436,100,550,0
Drumconrath,Meath,76,0,6,2,326,60,470,0
Drumkeen,Donegal,38,2,4,0,366,22,432,0
Drumkeeran,Leitrim,6,0,0,2,184,70,262,0
Drumlish,Longford,230,0,18,18,976,172,1414,0
Drumod,Leitrim,156,4,2,26,668,30,886,0
Drumshanbo,Leitrim,40,0,6,12,1028,238,1324,0
Drumsna,Leitrim,44,2,0,2,272,2,322,0
Duagh,Kerry,22,0,4,0,292,44,362,0
Dublin city and suburbs,Dublin,225800,9312,2960,104860,689012,440362,1472306,1
Duleek,Meath,1450,8,14,46,4580,358,6456,0
Dumha Thuama,Mayo,34,0,0,2,60,4,100,0
Dunboyne,Meath,742,32,32,528,5740,2594,9668,0
Duncannon,Wexford,12,0,0,2,192,34,240,0
Duncormick,Wexford,26,0,0,0,178,12,216,0
Dundalk,Louth,4392,110,84,440,31450,11704,48180,3
Dunderrow,Cork,30,0,0,0,216,70,316,0
Dundrum,Tipperary,56,0,0,0,188,28,272,0
Dunfanaghy,Donegal,52,0,2,0,318,68,440,0
Dungarvan,Waterford,326,12,30,14,7846,3138,11366,0
Dunhill,Waterford,28,2,2,0,244,34,310,0
Dunkineely,Donegal,58,0,2,0,288,36,384,0
Dunlavin,Wicklow,14,4,4,0,828,340,1190,0
Dunleer,Louth,202,4,14,10,1772,682,2684,0
Dunmanway,Cork,62,2,10,6,1636,446,2162,0
Dunmore,Galway,26,0,2,0,556,208,792,0
Dunmore East,Waterford,228,0,6,10,1632,232,2108,0
Dunshaughlin,Meath,820,14,18,116,5936,2000,8904,0
Durrow,Laois,144,0,10,12,784,156,1106,0
Durrus,Cork,54,0,2,0,312,54,422,0
Easky,Sligo,16,0,2,0,182,40,240,0
Edenderry,Offaly,672,22,24,34,6330,2434,9516,0
Edgeworthstown,Longford,406,2,2,72,1280,458,2220,0
Elphin,Roscommon,34,2,4,10,546,174,770,0
Emly,Tipperary,34,0,0,2,298,52,386,0
Emo,Laois,40,2,2,6,242,32,324,0
Emyvale,Monaghan,108,0,6,0,580,86,780,0
Enfield,Meath,776,12,8,146,2992,1242,5176,0
Ennis,Clare,1002,58,70,246,26250,5554,33180,3
Enniscorthy,Wexford,732,18,38,30,9258,2958,13034,0
Enniscrone,Sligo,36,0,2,12,1022,264,1336,0
Enniskerry,Wicklow,216,14,14,106,1788,166,2304,0
Ennistimon,Clare,22,6,4,4,780,400,1216,0
Errill,Laois,34,0,4,0,196,14,248,0
Eyrecourt,Galway,36,0,2,4,172,36,250,0
Fahan,Donegal,66,0,2,0,504,14,586,0
Farran,Cork,28,0,4,0,356,24,412,0
Feakle,Clare,10,0,0,0,72,20,102,0
Fedamore,Limerick,46,0,0,0,414,14,474,0
Fenit,Kerry,28,0,4,4,630,68,734,0
Fennagh,Carlow,130,0,4,4,474,20,632,0
Ferbane,Offaly,28,2,4,12,1148,214,1408,0
Fermoy,Cork,286,22,20,10,5744,1994,8076,0
Ferns,Wexford,196,2,6,0,932,300,1436,0
Fethard,Tipperary,94,0,10,8,1496,356,1964,0
Fethard,Wexford,64,0,0,0,286,28,378,0
Fiddown,Kilkenny,42,0,2,0,514,20,578,0
Fieries,Kerry,124,2,6,0,630,154,916,0
Foxford,Mayo,62,0,4,6,1256,200,1528,0
Foynes,Limerick,46,0,0,0,446,78,570,0
Freemount,Cork,28,0,0,0,274,44,346,0
Frenchpark,Roscommon,60,0,6,4,392,76,538,0
Freshford,Kilkenny,84,2,8,0,406,84,584,0
Galbally,Limerick,32,0,2,4,194,36,268,0
Galway city and suburbs,Galway,11670,316,208,380,57788,29600,99962,2
Garristown,Dublin,244,2,0,6,522,88,862,0
Geashill,Offaly,64,2,2,8,310,94,480,0
Glanworth,Cork,84,2,0,6,576,122,790,0
Glaslough,Monaghan,46,0,4,2,430,38,520,0
Glassan,Westmeath,16,0,0,8,214,18,256,0
Gleann Cholm Cille,Donegal,14,0,0,0,110,38,162,0
Glenamaddy,Galway,32,0,8,0,414,214,668,0
Glenbeigh,Kerry,32,2,0,2,354,36,426,0
Glencullen,Dublin,18,2,2,34,408,38,502,0
Glenealy,Wicklow,102,4,10,10,612,72,810,0
Gleneely,Donegal,36,0,4,0,216,38,294,0
Glengarriff,Cork,34,0,0,2,142,42,220,0
Glenties,Donegal,30,0,6,0,802,196,1034,0
Glenville,Cork,130,2,4,0,568,102,806,0
Glin,Limerick,56,0,0,0,508,122,686,0
Gneevgullia,Kerry,50,0,6,2,320,32,410,0
Gob an Choire,Mayo,8,0,0,0,168,52,228,0
Golden,Tipperary,36,0,6,8,334,42,426,0
Goresbridge,Kilkenny,22,0,0,6,248,44,320,0
Gorey,Wexford,796,26,28,104,9662,3736,14352,0
Gormanston,Meath,28,0,0,20,284,24,356,0
Gort,Galway,174,2,4,30,2222,678,3110,0
Gort An Choirce,Donegal,28,0,4,0,280,46,358,0
Gortnahoo,Tipperary,46,0,6,0,242,64,358,0
Gowran,Kilkenny,116,0,6,4,784,130,1040,0
Graiguenamanagh-Tinnahinch,Kilkenny,82,6,2,14,976,282,1362,0
Granard,Longford,28,0,4,2,614,388,1036,0
Grange,Sligo,40,0,0,2,532,198,772,0
Greencastle,Donegal,158,4,10,4,1194,84,1454,0
Grenagh,Cork,106,0,2,0,934,28,1070,0
Greystones-Delgany,Wicklow,1972,104,78,2674,17024,4688,26540,3
Gurteen,Sligo,50,0,2,2,412,78,544,0
Hacketstown,Carlow,12,0,6,0,486,224,728,0
Halfway,Cork,32,0,6,0,328,0,366,0
Headford,Galway,58,0,12,0,1222,220,1512,0
Holycross,Tipperary,54,0,0,26,716,48,844,0
Hospital,Limerick,36,0,2,2,550,182,772,0
Inagh,Clare,18,0,2,0,214,18,252,0
Inchigeelagh,Cork,6,0,0,0,128,20,154,0
Inishannon,Cork,144,4,2,0,1066,248,1464,0
Inistioge,Kilkenny,44,0,0,0,236,40,320,0
Inniskeen,Monaghan,50,2,8,0,316,72,448,0
Irishtown,Mayo,22,0,6,0,168,32,228,0
Jenkinstown,Louth,86,0,6,8,416,2,518,0
Johnstown,Kildare,458,0,4,24,1412,88,1986,0
Johnstown,Kilkenny,20,2,0,0,358,88,468,0
Johnstownbridge,Kildare,160,0,4,20,610,108,902,0
Julianstown,Meath,146,2,0,26,650,114,938,0
Kanturk,Cork,152,2,18,28,2498,668,3366,0
Keadew,Roscommon,22,0,2,4,168,14,210,0
Keel-Dooagh,Mayo,52,0,2,2,356,56,468,0
Keenagh,Longford,162,0,2,8,640,136,948,0
Kells,Kilkenny,32,0,2,2,346,26,408,0
Kells,Meath,884,16,20,8,5138,1700,7766,0
Kenmare,Kerry,74,4,8,8,1982,732,2808,0
Kentstown,Meath,312,2,4,0,1126,204,1648,0
Kernanstown,Carlow,6,0,0,2,218,28,254,0
Keshcarrigan,Leitrim,42,0,0,4,188,12,246,0
Kilbeggan,Westmeath,60,2,12,8,1288,434,1804,0
Kilberry,Kildare,36,0,4,4,290,22,356,0
Kilbrin,Cork,18,0,2,0,186,26,232,0
Kilbrittain,Cork,34,0,2,0,216,46,298,0
Kilcloon,Meath,42,2,2,30,456,62,594,0
Kilcock,Kildare,976,38,20,696,7518,2534,11782,0
Kilcolgan,Galway,26,0,2,2,226,26,282,0
Kilcoole,Wicklow,536,20,14,300,3924,1146,5940,0
Kilcormac,Offaly,44,2,14,4,760,270,1094,0
Kilcullen,Kildare,228,10,12,76,3584,1384,5294,0
Kilcummin,Kerry,34,0,0,4,740,36,814,0
Kildalkey,Meath,166,6,4,4,690,172,1042,0
Kildangan,Kildare,118,0,2,26,500,88,734,0
Kildare,Kildare,1012,30,22,724,9220,2192,13200,0
Kildavin,Carlow,6,0,4,0,172,22,204,0
Kildimo,Limerick,44,0,0,0,604,44,692,0
Kildorrery,Cork,46,0,2,2,352,72,474,0
Kildrum,Donegal,66,0,2,2,610,6,686,0
Kildysart,Clare,14,0,4,0,438,96,552,0
Kilfenora,Clare,16,2,0,0,118,30,166,0
Kilfinnane,Limerick,30,2,6,2,560,216,816,0
Kilflynn,Kerry,2,0,0,2,178,14,196,0
Kilgarvan,Kerry,18,2,0,0,268,30,318,0
Kilkee,Clare,40,0,4,0,552,196,792,0
Kilkelly,Mayo,26,0,2,0,440,42,510,0
Kilkenny,Kilkenny,1564,82,66,252,21044,8804,31812,3
Kilkishen,Clare,94,2,10,2,652,110,870,0
Kill,Kildare,808,14,8,24,3654,604,5112,0
Kill,Waterford,72,2,2,0,276,72,424,0
Killala,Mayo,68,0,4,2,472,74,620,0
Killaloe,Clare,96,0,16,0,1234,504,1850,0
Killarney,Kerry,750,42,56,96,10416,4364,15724,3
Killashee,Longford,16,0,0,2,202,22,242,0
Killavullen,Cork,34,0,4,0,278,52,368,0
Killeagh,Cork,156,0,0,16,846,166,1184,0
Killeigh,Offaly,44,0,0,6,166,26,242,0
Killenard,Laois,92,0,4,40,606,166,908,0
Killenaule,Tipperary,38,2,6,2,612,106,766,0
Killeshandra,Cavan,36,0,0,0,152,56,244,0
Killimor,Galway,30,0,6,2,238,54,330,0
Killinierin,Wexford,26,0,2,6,288,46,368,0
Killorglin,Kerry,84,8,6,10,1798,582,2488,0
Killucan-Rathwire,Westmeath,204,2,12,8,1398,374,1998,0
Killumney,Cork,156,0,6,0,1816,90,2068,0
Killurin,Offaly,30,0,2,4,166,6,208,0
Killurin,Wexford,10,0,4,0,276,6,296,0
Killybegs,Donegal,34,2,8,2,1030,238,1314,0
Killygordon,Donegal,110,0,0,0,652,116,878,0
Kilmacanogue,Wicklow,142,4,18,52,1032,142,1390,0
Kilmacow,Kilkenny,68,2,4,0,666,42,782,0
Kilmacrennan,Donegal,176,2,4,0,744,100,1026,0
Kilmacthomas,Waterford,38,2,10,0,810,192,1052,0
Kilmaine,Mayo,30,0,2,2,150,34,218,0
Kilmainhamwood,Meath,56,2,4,2,192,68,324,0
Kilmaley,Clare,38,2,0,2,354,12,408,0
Kilmallock,Limerick,36,2,10,2,1210,458,1718,0
Kilmead,Kildare,78,0,6,8,308,68,468,0
Kilmeaden,Waterford,22,0,0,0,476,6,504,0
Kilmeage,Kildare,168,2,4,14,1102,46,1336,0
Kilmessan,Meath,156,2,0,8,836,222,1224,0
Kilmihil,Clare,6,0,6,4,394,92,502,0
Kilmoganny,Kilkenny,22,0,0,0,226,24,272,0
Kilmore,Wexford,12,4,0,0,204,24,244,0
Kilmore Quay,Wexford,80,0,8,0,328,44,460,0
Kilmuckridge,Wexford,48,6,4,0,604,206,868,0
Kilmurry,Clare,56,0,2,0,248,30,336,0
Kilnaleck,Cavan,60,2,4,0,392,140,598,0
Kilpedder,Wicklow,178,6,12,54,1236,56,1542,0
Kilrush,Clare,36,2,10,6,1502,696,2252,0
Kilsheelan,Tipperary,124,0,2,0,876,102,1104,0
Kilteel,Kildare,42,4,0,8,270,4,328,0
Kilteely,Limerick,18,0,0,0,186,10,214,0
Kiltimagh,Mayo,30,2,10,12,1062,280,1396,0
Kilworth,Cork,142,4,10,0,1070,308,1534,0
Kingscourt,Cavan,140,0,20,6,2924,636,3726,0
Kinlough,Leitrim,138,0,18,2,1198,172,1528,0
Kinnegad,Westmeath,884,10,8,18,2380,656,3956,0
Kinnitty,Offaly,38,0,0,0,238,58,334,0
Kinsale,Cork,306,16,20,20,4692,1788,6842,0
Kinsaley,Dublin,112,0,2,92,742,86,1034,0
Kinsealy-Drinan,Dublin,1758,44,34,142,6546,2020,10544,0
Kinvarra,Galway,56,0,6,4,600,272,938,0
Knightstown,Kerry,32,6,0,0,164,28,230,0
Knock,Mayo,82,2,6,2,746,108,946,0
Knockananna,Wicklow,34,0,8,2,184,14,242,0
Knockbridge,Louth,118,4,2,4,728,164,1020,0
Knockcroghery,Roscommon,56,0,2,4,426,44,532,0
Knocklong,Limerick,26,0,4,0,200,14,244,0
Knocknagree,Cork,20,2,0,0,188,38,248,0
Knockraha,Cork,56,2,0,4,536,180,778,0
Knocktopher,Kilkenny,22,0,2,0,180,16,220,0
Lackaghbeg,Galway,116,0,8,2,584,156,866,0
Ladysbridge,Cork,228,2,0,8,872,40,1150,0
Laghy,Donegal,2,0,4,0,154,24,184,0
Lahardane,Mayo,36,0,0,0,222,18,276,0
Lanesborough-Ballyleague,Roscommon,108,2,2,16,1564,304,1996,0
Laragh,Wicklow,52,2,2,2,386,92,536,0
Laytown-Bettystown-Mornington-Donacarney,Meath,3678,46,40,836,13256,2456,20312,3
Leap,Cork,4,2,2,0,124,4,136,0
Legan,Longford,48,0,4,0,290,58,400,0
Lehinch,Clare,36,2,0,2,794,108,942,0
Leighlinbridge,Carlow,126,0,0,8,992,122,1248,0
Leitrim,Leitrim,80,0,4,6,696,126,912,0
Leixlip,Kildare,2236,94,32,1842,11794,4658,20656,3
Lemybrien,Waterford,20,0,6,0,272,6,304,0
Letterkenny,Donegal,2608,14,68,30,19522,3916,26158,3
Lifford,Donegal,192,0,8,2,1268,182,1652,0
Limerick city and suburbs,Limerick,9668,368,194,318,69568,30006,110122,2
Liscannor,Clare,6,0,0,0,100,6,112,0
Liscarroll,Cork,14,0,0,0,190,40,244,0
Lisdoonvarna,Clare,10,2,0,0,294,154,460,0
Lismore,Waterford,54,4,20,0,1030,510,1618,0
Lisronagh,Tipperary,26,2,2,0,230,16,276,0
Lissycasey,Clare,86,0,2,0,512,4,604,0
Listowel,Kerry,224,4,18,12,3958,884,5100,0
Littleton,Tipperary,60,0,2,4,286,82,434,0
Lixnaw,Kerry,128,2,4,0,794,70,998,0
Loch An Iúir,Donegal,72,0,0,0,310,26,408,0
Loch Gowna,Cavan,8,0,0,0,144,36,188,0
Longford,Longford,760,12,36,212,6942,3074,11036,0
Longwood,Meath,136,2,14,20,1482,706,2360,0
Loughglinn,Roscommon,10,0,4,2,154,34,204,0
Loughrea,Galway,418,8,20,10,5490,1404,7350,0
Loughshinny,Dublin,108,6,4,62,494,122,796,0
Louisburgh,Mayo,12,0,2,0,300,64,378,0
Louth,Louth,142,2,2,2,610,102,860,0
Lusk,Dublin,1536,48,22,634,7048,2784,12072,0
Lyre,Cork,22,0,0,0,148,50,220,0
Macroom,Cork,160,6,24,8,3924,1064,5186,0
Maigh Cuilinn,Galway,284,6,8,10,2096,442,2846,0
Malahide,Dublin,2010,46,44,3284,12698,4340,22422,3
Malin,Donegal,2,0,0,0,64,8,74,0
Mallow,Cork,582,22,62,428,12144,2932,16170,3
Manor Kilbride,Wicklow,20,0,4,2,184,6,216,0
Manorcunningham,Donegal,178,0,6,2,766,24,976,0
Manorhamilton,Leitrim,64,2,12,4,1306,522,1910,0
Maynooth,Kildare,1766,84,34,2166,12062,7018,23130,3
Midleton,Cork,976,32,24,718,13762,3020,18532,3
Milford,Cork,20,0,0,0,254,20,294,0
Milford,Donegal,74,4,8,0,932,160,1178,0
Millstreet,Cork,76,0,20,18,1642,314,2070,0
Milltown,Galway,28,0,4,2,242,8,284,0
Milltown,Kerry,70,2,4,4,1042,296,1418,0
Milltown,Kildare,28,4,14,12,366,26,450,0
Miltown Malbay,Clare,36,0,2,4,852,116,1010,0
Mitchelstown,Cork,110,4,4,2,3010,1094,4224,0
Moate,Westmeath,140,6,6,22,2698,558,3430,0
Model Village or Dripsey,Cork,56,0,4,0,306,10,376,0
Mogeely,Cork,64,4,2,4,554,24,652,0
Mohill,Leitrim,26,0,6,14,742,222,1010,0
Monaghan,Monaghan,466,10,22,22,6608,1998,9126,0
Monamolin,Wexford,58,0,0,0,252,18,328,0
Monard,Tipperary,28,0,6,8,260,50,352,0
Monasterevin,Kildare,530,10,26,248,5018,966,6798,0
Moneenroe,Kilkenny,60,0,6,2,744,62,874,0
Moneygall,Offaly,48,0,2,2,360,34,446,0
Monivea,Galway,26,0,4,8,508,62,608,0
Mooncoin,Kilkenny,72,0,6,6,976,214,1274,0
Moroe,Limerick,192,4,8,0,1510,232,1946,0
Mountbellew,Galway,32,0,2,2,788,126,950,0
Mountcharles,Donegal,98,2,4,2,660,82,848,0
Mountcollins,Limerick,22,2,4,0,220,4,252,0
Mountmellick,Laois,278,2,14,140,4194,1190,5818,0
Mountrath,Laois,160,4,10,26,1590,456,2246,0
Mountshannon,Clare,28,0,2,0,220,28,278,0
Moville,Donegal,106,2,6,2,1038,280,1434,0
Moylough,Galway,54,0,0,2,648,50,754,0
Mucklagh,Offaly,102,2,6,26,930,116,1182,0
Muff,Donegal,220,4,10,0,1458,108,1800,0
Muinebeag (Bagenalstown),Carlow,102,4,14,60,2138,1054,3372,0
Mullagh,Cavan,322,2,10,2,1490,304,2130,0
Mullaghmore,Sligo,10,0,4,2,114,8,138,0
Mullinahone,Tipperary,66,2,0,0,418,98,584,0
Mullinavat,Kilkenny,18,0,0,2,164,20,204,0
Mullingar,Westmeath,1004,64,90,544,19164,5576,26442,3
Mulranny,Mayo,52,0,0,0,206,52,310,0
Multyfarnham,Westmeath,42,0,4,4,360,96,506,0
Mungret,Limerick,42,0,0,2,422,38,504,0
Murntown,Wexford,28,2,0,0,376,32,438,0
Myrtleville,Cork,70,0,10,6,952,64,1102,0
Myshall,Carlow,52,0,0,2,260,26,340,0
Mín Lárach,Donegal,64,0,2,4,356,20,446,0
Na Dúnaibh,Donegal,122,0,6,0,502,38,668,0
Na Forbacha,Galway,80,0,0,4,812,124,1020,0
Naas,Kildare,2620,128,76,1500,23488,6738,34550,3
Narraghmore,Kildare,100,4,0,6,440,18,568,0
Naul,Dublin,104,0,6,26,712,128,976,0
Navan,Meath,4880,88,96,140,28866,9904,43974,3
Nenagh,Tipperary,450,14,24,22,8688,2992,12190,0
New Ross,Wexford,668,14,34,12,6710,1810,9248,0
Newbawn,Wexford,24,0,0,0,142,18,184,0
Newbliss,Monaghan,44,0,0,0,326,50,420,0
Newbridge,Kildare,1836,94,66,1736,20074,7288,31094,3
Newcastle,Dublin,780,20,10,126,4108,1034,6078,0
Newcastle,Tipperary,64,0,2,0,264,94,424,0
Newcastle,Wicklow,160,8,4,62,938,94,1266,0
Newcastle West,Limerick,444,4,14,12,6540,1564,8578,0
Newmarket,Cork,48,0,8,6,958,128,1148,0
Newmarket-On-Fergus,Clare,208,8,4,2,1848,286,2356,0
Newport,Mayo,68,0,8,2,652,134,864,0
Newport,Tipperary,112,2,6,0,2352,538,3010,0
Newtown,Cork,30,0,6,0,444,70,550,0
Newtown,Laois,36,0,2,0,274,18,330,0
Newtown,Tipperary,24,0,6,0,484,68,582,0
Newtowncunningham,Donegal,246,2,4,2,1014,176,1444,0
Newtownforbes,Longford,112,2,2,14,710,114,954,0
Newtownmountkennedy,Wicklow,670,14,26,68,3318,576,4672,0
Newtownsandes,Kerry,40,0,0,0,308,42,390,0
Nobber,Meath,28,0,0,0,280,152,460,0
Nurney,Kildare,84,0,6,16,440,114,660,0
O'Briensbridge-Montpelier,Clare,56,0,10,0,430,12,508,0
Oilgate,Wexford,40,0,4,0,352,46,442,0
Oldcastle,Meath,44,2,16,4,1108,604,1778,0
Oldtown,Dublin,92,2,6,2,530,54,686,0
Omeath,Louth,124,2,6,0,558,92,782,0
Oola,Limerick,36,0,2,4,258,28,328,0
Oram,Monaghan,16,0,4,0,164,24,208,0
Oranmore,Galway,436,18,10,120,5970,1400,7954,0
Oughterard,Galway,134,6,8,4,1696,336,2184,0
Oulart,Wexford,22,0,2,4,214,24,266,0
Palatine,Carlow,16,0,2,4,348,6,376,0
Pallasgreen,Limerick,52,0,2,0,202,20,276,0
Pallaskenry,Limerick,12,0,4,0,584,168,768,0
Parteen,Clare,32,2,4,4,776,160,978,0
Passage East,Waterford,40,4,2,0,712,74,832,0
Passage West-Monkstown,Cork,654,24,28,6,6240,678,7630,0
Patrickswell,Limerick,114,4,4,0,728,134,984,0
Paulstown,Kilkenny,154,2,2,0,996,132,1286,0
Pettigo,Donegal,20,0,2,0,96,16,134,0
Piercetown,Wexford,16,0,2,0,296,36,350,0
Piltown,Kilkenny,184,2,8,2,1212,208,1616,0
Pollagh,Offaly,54,0,2,0,178,18,252,0
Portarlington,Laois,1172,18,36,650,7934,1676,11486,0
Portlaoise,Laois,2156,64,84,792,20472,4610,28178,3
Portlaw,Waterford,380,8,4,2,1696,332,2422,0
Portmagee,Kerry,30,0,4,0,68,30,132,0
Portmarnock,Dublin,724,42,16,2170,6590,2954,12496,0
Portrane,Dublin,166,10,8,136,1006,118,1444,0
Portroe,Tipperary,62,0,6,0,454,44,566,0
Portumna,Galway,32,0,6,12,1286,448,1784,0
Prosperous,Kildare,310,6,8,34,2222,552,3132,0
Puckaun,Tipperary,24,0,0,0,222,28,274,0
Quigleys Point,Donegal,52,0,0,0,192,12,256,0
Quilty,Clare,6,0,0,0,176,8,190,0
Quin,Clare,104,4,6,2,1004,190,1310,0
Raharney,Westmeath,30,2,0,4,140,12,188,0
Ramelton,Donegal,204,0,6,0,1006,166,1382,0
Rampark,Louth,78,0,2,4,444,80,608,0
Rann Na Feirste,Donegal,74,0,2,0,324,30,430,0
Raphoe,Donegal,50,0,10,0,784,246,1090,0
Rathangan,Kildare,98,10,8,94,3268,784,4262,0
Rathard-Aherla,Cork,106,0,6,0,736,18,866,0
Rathcoffey,Kildare,56,0,2,12,314,64,448,0
Rathcoole,Cork,42,0,2,2,218,36,300,0
Rathcoole,Dublin,422,32,16,148,4636,2108,7362,0
Rathcormac,Cork,388,6,10,4,1890,518,2816,0
Rathdowney,Laois,54,0,4,24,1164,408,1654,0
Rathdrum,Wicklow,80,6,8,110,1974,614,2792,0
Rathkeale,Limerick,32,0,10,0,590,312,944,0
Rathmolyon,Meath,84,0,4,12,502,24,626,0
Rathmore,Kerry,126,2,6,12,868,40,1054,0
Rathmullan,Donegal,50,0,4,2,386,82,524,0
Rathnew,Wicklow,276,12,22,44,3490,818,4662,0
Rathowen,Westmeath,32,0,2,0,132,36,202,0
Rathtoe,Carlow,42,2,0,4,352,50,450,0
Rathvilly,Carlow,138,2,8,0,1012,146,1306,0
Ratoath,Meath,1544,32,18,116,9354,3642,14706,0
Rear Cross,Tipperary,20,0,6,0,114,36,176,0
Redcross,Wicklow,60,0,0,8,218,38,324,0
Rhode,Offaly,156,0,4,0,712,82,954,0
Ringaskiddy-Loughbeg,Cork,62,0,8,2,648,86,806,0
Rivermeade,Dublin,132,0,2,0,354,116,604,0
Riverstick,Cork,238,2,0,2,888,34,1164,0
Riverstown,Sligo,38,0,4,2,376,58,478,0
Robertstown,Kildare,86,2,4,6,792,72,962,0
Robinstown,Meath,74,0,4,2,396,108,584,0
Rochfortbridge,Westmeath,136,0,24,6,1194,468,1828,0
Rockcorry,Monaghan,46,2,4,0,264,46,362,0
Roosky,Leitrim,94,0,4,12,654,110,874,0
Roscommon,Roscommon,254,10,32,70,5814,1560,7740,0
Roscrea,Tipperary,388,8,52,22,4808,1314,6592,0
Rosegreen,Tipperary,22,0,0,0,216,34,272,0
Rosscahill,Galway,38,0,0,0,392,30,460,0
Rosscarbery,Cork,14,2,4,0,566,108,694,0
Rosses Point,Sligo,68,2,0,8,764,118,960,0
Rosslare,Wexford,218,2,8,32,1470,210,1940,0
Rosslare Harbour,Wexford,342,2,24,8,1712,258,2346,0
Roundstone,Galway,32,0,2,0,124,30,188,0
Roundwood,Wicklow,204,4,4,8,778,224,1222,0
Rush,Dublin,1790,56,62,1052,8350,2900,14210,3
Saggart,Dublin,346,30,2,418,2792,834,4422,0
Saleen,Cork,86,2,2,10,658,72,830,0
Sallins,Kildare,1018,28,18,1018,5270,1454,8806,0
Scarriff-Tuamgraney,Clare,18,0,6,0,470,172,666,0
Schull,Cork,14,4,6,0,432,180,636,0
Scotshouse,Monaghan,74,0,0,0,316,42,432,0
Scotstown,Monaghan,68,2,0,6,490,32,598,0
Shanagarry,Cork,90,2,8,12,700,78,890,0
Shanagolden,Limerick,12,0,0,0,130,8,150,0
Shanbally,Cork,32,2,0,0,402,68,504,0
Shanballymore,Cork,30,0,2,4,166,38,240,0
Shannon,Clare,696,34,38,12,8318,3710,12808,0
Shannonbridge,Offaly,36,0,0,0,98,6,140,0
Shercock,Cavan,70,0,2,2,500,212,786,0
Shillelagh,Wicklow,36,0,0,0,376,52,464,0
Shinrone,Offaly,82,0,6,4,498,108,698,0
Shrule,Mayo,50,0,0,0,364,32,446,0
Silvermines,Tipperary,36,2,2,0,280,26,346,0
Sixmilebridge,Clare,446,10,18,46,2966,478,3964,0
Skerries,Dublin,606,34,26,2244,6622,3734,13266,0
Skibbereen,Cork,68,2,12,2,2382,880,3346,0
Slane,Meath,340,2,6,2,1192,276,1818,0
Slieverue,Kilkenny,50,2,2,2,424,66,546,0
Sligo,Sligo,978,60,50,102,14140,7430,22760,3
Smithborough,Monaghan,80,0,2,0,550,52,684,0
Sneem,Kerry,46,0,0,0,184,146,376,0
Spa,Kerry,6,0,0,6,380,40,432,0
Spanish Point,Clare,8,0,0,10,220,16,254,0
St. Johnston,Donegal,90,0,0,0,410,76,576,0
Stamullen,Meath,614,4,10,202,3982,870,5682,0
Stoneyford,Kilkenny,14,0,0,2,252,26,294,0
Stradbally,Laois,186,0,10,18,1126,200,1540,0
Stradbally,Waterford,54,0,0,0,516,30,600,0
Straffan,Kildare,132,2,0,28,1148,260,1570,0
Strandhill,Sligo,134,2,4,16,1956,318,2430,0
Stratford,Wicklow,12,0,0,0,214,36,262,0
Strokestown,Roscommon,46,0,2,2,620,194,864,0
Summerhill,Meath,180,2,10,14,894,106,1206,0
Suncroft,Kildare,50,2,0,8,370,70,500,0
Swanlinbar,Cavan,24,0,6,0,114,94,238,0
Swinford,Mayo,44,0,4,2,1068,386,1504,0
Swords,Dublin,10364,282,90,422,32242,10730,54130,3
Taghmon,Wexford,112,0,12,0,430,152,706,0
Tagoat,Wexford,88,0,2,2,508,56,656,0
Tallanstown,Louth,110,0,0,8,634,134,886,0
Tallow,Waterford,166,0,4,0,712,258,1140,0
Tarbert,Kerry,10,0,2,0,360,148,520,0
Templemore,Tipperary,34,8,12,54,1582,620,2310,0
Templetuohy,Tipperary,24,0,0,0,212,40,276,0
Termonbarry,Roscommon,82,4,2,10,772,46,916,0
Termonfeckin,Louth,298,4,8,40,1942,198,2490,0
The Ballagh,Wexford,62,0,6,0,574,50,692,0
The Commons,Tipperary,8,2,0,4,104,34,152,0
The Swan,Laois,48,0,0,4,270,32,354,0
Thomastown,Kilkenny,150,4,14,34,2110,590,2902,0
Three Mile House,Monaghan,22,0,2,0,130,20,174,0
Thurles,Tipperary,184,10,34,184,6750,2124,9286,0
Tievebane,Donegal,70,2,6,2,490,46,616,0
Timoleague,Cork,46,0,0,0,266,176,488,0
Tinahely,Wicklow,184,4,10,4,902,142,1246,0
Tinryland,Carlow,40,0,8,4,338,30,420,0
Tinure,Louth,142,0,0,8,490,122,762,0
Tipperary,Tipperary,150,8,20,76,3982,1458,5694,0
Toomevara,Tipperary,24,0,0,0,186,56,266,0
Toornafulla,Limerick,28,0,0,0,218,20,266,0
Tower,Cork,322,4,2,0,3950,148,4426,0
Tralee,Kerry,1118,48,70,90,19390,6268,26984,3
Tramore,Waterford,818,30,28,48,10600,2378,13902,0
Trim,Meath,1174,18,30,46,8642,2302,12212,0
Tuam,Galway,670,22,34,14,8108,2162,11010,0
Tubbercurry,Sligo,160,6,14,8,1916,410,2514,0
Tulla,Clare,28,0,6,4,684,180,902,0
Tullaghan,Leitrim,12,0,4,0,312,12,340,0
Tullamore,Offaly,1274,28,52,446,12244,3828,17872,3
Tullow,Carlow,278,0,20,16,4516,1304,6134,0
Tullyallen,Louth,388,6,4,28,1674,370,2470,0
Tulsk,Roscommon,22,0,2,4,184,20,232,0
Turlough,Mayo,36,0,2,0,572,8,618,0
Turloughmore,Galway,30,0,2,0,298,4,334,0
Two Mile House,Kildare,76,0,2,22,522,80,702,0
Twomileborris,Tipperary,34,0,2,8,514,50,608,0
Tyrrellspass,Westmeath,42,0,2,2,306,74,426,0
Unionhall,Cork,54,0,0,0,302,66,422,0
Urlingford,Kilkenny,120,2,10,12,876,312,1332,0
Villierstown,Waterford,50,0,2,0,240,46,338,0
Virginia,Cavan,282,6,18,10,2730,878,3924,0
Walsh Island or Coolagary,Offaly,68,0,4,8,368,92,540,0
Waterford city and suburbs,Waterford,3786,284,186,182,48764,14232,67434,2
Watergrasshill,Cork,302,0,16,2,2004,456,2780,0
Waterville,Kerry,102,0,6,0,388,108,604,0
Westport,Mayo,358,12,10,50,5124,2274,7828,0
Wexford,Wexford,980,52,66,82,17430,5748,24358,3
Whitechurch,Cork,66,4,4,0,1048,12,1134,0
Whitegate,Clare,18,0,2,0,172,8,200,0
Whitegate,Cork,234,2,4,10,1398,90,1738,0
Wicklow,Wicklow,1070,38,40,464,11564,2834,16010,3
Williamstown,Galway,10,0,2,0,176,28,216,0
Woodford,Galway,2,0,4,0,244,26,276,0
Youghal,Cork,786,12,36,22,7088,1338,9282,0
