,Town,County,Latitude,Longitude,Bus,Motorcycle,Other,Rail,Car,Bicyle / On Foot,Total,Cluster,Classification,Public,Private,Public to Private Ratio
0,Abbeydorney,Kerry,52.346618,-9.6879095,68,0,2,2,604,54,730,0,Town (Small),70,604,0.11589403973509933
1,Abbeyfeale,Limerick,52.3851792,-9.3007966,64,2,10,2,1840,476,2394,0,Town (Small),66,1842,0.035830618892508145
2,Abbeyknockmoy,Galway,53.43649,-8.74804,76,0,2,0,378,18,474,0,Town (Small),76,378,0.20105820105820105
3,Abbeyleix,Laois,52.9152801,-7.347892300000001,258,4,6,46,1560,304,2178,0,Town (Small),304,1564,0.19437340153452684
4,Adamstown,Wexford,52.3935687,-6.7185567,10,0,0,0,262,78,350,0,Town (Small),10,262,0.03816793893129771
5,Adare,Limerick,52.5636521,-8.7925281,106,0,8,4,1094,262,1474,0,Town (Small),110,1094,0.10054844606946983
6,Aghada-Rostellan,Cork,51.8394856,-8.2149056,168,2,0,14,1098,100,1382,0,Town (Small),182,1100,0.16545454545454547
7,Aglish,Waterford,52.0715072,-7.822269599999999,50,2,2,0,272,52,378,0,Town (Small),50,274,0.18248175182481752
8,Ahascragh,Galway,53.3976127,-8.3346318,12,0,6,2,154,8,182,0,Town (Small),14,154,0.09090909090909091
9,Ailt An Chorráin,Donegal,54.9845286,-8.4326581,30,0,0,0,204,32,266,0,Town (Small),30,204,0.14705882352941177
10,Allenwood,Kildare,53.2839545,-6.8618405,246,8,24,20,1784,168,2250,0,Town (Small),266,1792,0.1484375
11,An Bun Beag,Donegal,55.060874,-8.3003485,46,0,6,0,670,90,812,0,Town (Small),46,670,0.06865671641791045
12,An Charraig,Donegal,54.6577244,-8.632748399999999,18,0,2,2,286,62,370,0,Town (Small),20,286,0.06993006993006994
13,An Cheathrú Rua,Galway,53.2641084,-9.5982671,30,0,2,2,486,120,640,0,Town (Small),32,486,0.06584362139917696
14,An Clochán Liath,Donegal,54.95028869999999,-8.357362799999999,44,4,4,4,942,220,1218,0,Town (Small),48,946,0.0507399577167019
15,An Fál Carrach,Donegal,55.13640840000001,-8.1044862,44,0,6,0,512,196,758,0,Town (Small),44,512,0.0859375
16,An Rinn,Waterford,52.04689450000001,-7.571887899999999,30,0,2,2,686,126,846,0,Town (Small),32,686,0.04664723032069971
17,An Spidéal,Galway,53.2441766,-9.3058803,10,0,0,0,242,70,322,0,Town (Small),10,242,0.04132231404958678
18,Anagaire,Donegal,55.02044,-8.31366,50,0,2,0,220,40,312,0,Town (Small),50,220,0.22727272727272727
19,Annacotty,Limerick,52.667128,-8.5324694,204,2,10,0,3040,956,4212,0,Town (Small),204,3042,0.0670611439842209
20,Annagassan,Louth,53.882628,-6.343494199999999,32,0,2,0,178,16,228,0,Town (Small),32,178,0.1797752808988764
21,Annaghdown,Galway,53.3881317,-9.0710338,26,0,2,0,230,2,260,0,Town (Small),26,230,0.11304347826086956
22,Annascaul,Kerry,52.1510786,-10.0567611,60,0,0,0,246,38,344,0,Town (Small),60,246,0.24390243902439024
23,Annayalla,Monaghan,54.16064,-6.788880000000001,34,0,2,0,238,42,316,0,Town (Small),34,238,0.14285714285714285
24,Ardagh,Limerick,52.4941478,-9.0637542,18,0,6,0,268,30,322,0,Town (Small),18,268,0.06716417910447761
25,Ardara,Donegal,54.7671456,-8.4092864,106,0,0,0,582,160,848,0,Town (Small),106,582,0.18213058419243985
26,Ardee,Louth,53.8576227,-6.5400009,366,4,20,12,4234,1684,6320,0,Town (Small),378,4238,0.08919301557338367
27,Ardfert,Kerry,52.3282825,-9.767440599999999,72,0,4,0,706,88,870,0,Town (Small),72,706,0.10198300283286119
28,Ardfinnan,Tipperary,52.3092483,-7.8842292,140,2,2,2,954,84,1184,0,Town (Small),142,956,0.14853556485355648
29,Ardmore,Waterford,51.9510741,-7.725328999999999,54,2,0,2,314,126,498,0,Town (Small),56,316,0.17721518987341772
30,Ardnacrusha,Clare,52.7104277,-8.602863,82,0,4,2,1564,50,1702,0,Town (Small),84,1564,0.05370843989769821
31,Arklow,Wicklow,52.79769349999999,-6.1599293,648,26,34,176,11320,3708,15912,3,Town (Medium),824,11346,0.07262471355543804
32,Arthurstown,Wexford,52.24206059999999,-6.9517472,6,0,4,0,116,14,140,0,Town (Small),6,116,0.05172413793103448
33,Arvagh,Cavan,53.9214383,-7.5799134,38,0,12,2,348,112,512,0,Town (Small),40,348,0.11494252873563218
34,Ashbourne,Meath,53.5111621,-6.3973818,2090,84,36,48,13612,5782,21652,3,Town (Medium),2138,13696,0.15610397196261683
35,Ashford,Wicklow,53.0107896,-6.108289000000001,216,8,4,30,1772,198,2228,0,Town (Small),246,1780,0.13820224719101123
36,Askeaton,Limerick,52.6005095,-8.975062,46,0,4,2,912,312,1276,0,Town (Small),48,912,0.05263157894736842
37,Athboy,Meath,53.6236329,-6.915636999999999,328,6,10,8,2190,664,3206,0,Town (Small),336,2196,0.15300546448087432
38,Athea,Limerick,52.4606497,-9.287626,52,0,6,0,320,80,458,0,Town (Small),52,320,0.1625
39,Athenry,Galway,53.3008131,-8.745376799999999,146,10,4,262,4528,1140,6090,0,Town (Small),408,4538,0.08990744821507272
40,Athgarvan,Kildare,53.15289079999999,-6.777700299999999,72,4,6,68,1416,142,1708,0,Town (Small),140,1420,0.09859154929577464
41,Athleague,Roscommon,53.5676272,-8.2567472,44,0,0,2,304,44,394,0,Town (Small),46,304,0.1513157894736842
42,Athlone,Westmeath,53.4239331,-7.940689799999999,2472,36,70,402,17500,5184,25664,3,Town (Medium),2874,17536,0.16389142335766424
43,Athy,Kildare,52.9918336,-6.985728,828,30,40,600,8744,2652,12894,0,Town (Small),1428,8774,0.16275359015272395
44,Aughnacliffe,Longford,53.84885,-7.60445,26,0,2,2,160,18,208,0,Town (Small),28,160,0.175
45,Aughrim,Wicklow,52.8559337,-6.325933099999999,308,4,6,16,1226,194,1754,0,Town (Small),324,1230,0.2634146341463415
46,Avoca,Wicklow,52.8586664,-6.2140891,116,4,8,20,600,128,876,0,Town (Small),136,604,0.2251655629139073
47,Baile Chláir,Galway,53.34090310000001,-8.9456735,126,8,0,4,1570,546,2254,0,Town (Small),130,1578,0.08238276299112801
48,Baile Mhic Íre,Cork,51.93639049999999,-9.1454314,18,0,4,0,336,112,470,0,Town (Small),18,336,0.05357142857142857
49,Bailieborough,Cavan,53.9156096,-6.969294199999999,158,2,18,2,2324,572,3076,0,Town (Small),160,2326,0.06878761822871883
50,Balbriggan,Dublin,53.6083194,-6.182079799999999,2650,76,60,2694,17318,8868,31666,3,Town (Medium),5344,17394,0.3072323789812579
51,Balla,Mayo,53.8043767,-9.1305014,26,0,10,0,926,154,1116,0,Town (Small),26,926,0.028077753779697623
52,Ballaghaderreen,Roscommon,53.9016968,-8.5792106,112,2,20,16,1548,670,2368,0,Town (Small),128,1550,0.08258064516129032
53,Ballina,Mayo,54.1149482,-9.1550693,1102,8,26,16,8734,2158,12044,0,Town (Small),1118,8742,0.12788835506749027
54,Ballina,Tipperary,52.8070154,-8.430917899999999,170,4,8,16,2732,988,3918,0,Town (Small),186,2736,0.06798245614035088
55,Ballinabrannagh,Carlow,52.785424,-6.984884200000001,68,0,12,12,610,136,838,0,Town (Small),80,610,0.13114754098360656
56,Ballinaclash,Wicklow,52.9052365,-6.2579487,82,0,4,12,280,2,380,0,Town (Small),94,280,0.3357142857142857
57,Ballinagar,Offaly,53.2662048,-7.337107199999998,38,0,2,0,354,46,440,0,Town (Small),38,354,0.10734463276836158
58,Ballinagh,Cavan,53.9302,-7.41044,180,0,4,2,904,160,1250,0,Town (Small),182,904,0.2013274336283186
59,Ballinakill,Laois,52.8745935,-7.3085929,10,0,6,6,454,54,530,0,Town (Small),16,454,0.03524229074889868
60,Ballinalack,Westmeath,53.63055809999999,-7.473040999999999,26,0,2,2,164,14,208,0,Town (Small),28,164,0.17073170731707318
61,Ballinalee,Longford,53.7750724,-7.6550915,52,0,4,8,346,34,444,0,Town (Small),60,346,0.17341040462427745
62,Ballinameen,Roscommon,53.8972258,-8.301216,24,0,4,0,296,2,326,0,Town (Small),24,296,0.08108108108108109
63,Ballinamore,Leitrim,54.0522181,-7.8032043,58,0,8,4,844,292,1206,0,Town (Small),62,844,0.07345971563981042
64,Ballinasloe,Galway,53.3281251,-8.2236807,356,12,36,116,4994,1272,6786,0,Town (Small),472,5006,0.09428685577307232
65,Ballincar,Sligo,54.2979892,-8.497289499999999,16,0,2,0,312,24,354,0,Town (Small),16,312,0.05128205128205128
66,Ballinderreen,Galway,53.18567210000001,-8.909645399999999,56,0,2,2,390,108,558,0,Town (Small),58,390,0.14871794871794872
67,Ballindine,Mayo,53.66925690000001,-8.9567295,50,0,4,0,438,68,560,0,Town (Small),50,438,0.1141552511415525
68,Ballindrait,Donegal,54.8451594,-7.526530599999999,8,0,2,0,70,4,84,0,Town (Small),8,70,0.11428571428571428
69,Ballineen-Enniskean,Cork,51.73824,-8.930579999999999,98,0,6,0,556,140,800,0,Town (Small),98,556,0.17625899280575538
70,Ballingarry,Limerick,52.4732187,-8.8627555,58,0,2,0,614,102,776,0,Town (Small),58,614,0.09446254071661238
71,Ballingarry,Tipperary,52.5863379,-7.5416271,22,0,2,8,218,40,290,0,Town (Small),30,218,0.13761467889908258
72,Ballinlough,Roscommon,53.7418858,-8.6335579,12,0,4,0,308,28,352,0,Town (Small),12,308,0.03896103896103896
73,Ballinroad,Waterford,52.1037518,-7.5734156,40,2,8,0,1810,160,2020,0,Town (Small),40,1812,0.02207505518763797
74,Ballinrobe,Mayo,53.6237338,-9.2211143,172,4,16,6,2650,836,3684,0,Town (Small),178,2654,0.06706857573474001
75,Ballinspittle,Cork,51.6663408,-8.596594099999999,58,0,0,0,330,74,462,0,Town (Small),58,330,0.17575757575757575
76,Ballintober,Roscommon,53.7180878,-8.4100998,8,0,2,2,206,20,238,0,Town (Small),10,206,0.04854368932038835
77,Ballintogher,Sligo,54.2006449,-8.3649676,60,0,4,0,392,48,504,0,Town (Small),60,392,0.15306122448979592
78,Ballintra,Donegal,54.57884989999999,-8.1243234,20,0,0,0,226,14,260,0,Town (Small),20,226,0.08849557522123894
79,Ballitore,Kildare,53.009742,-6.8156295,82,0,0,6,644,30,762,0,Town (Small),88,644,0.13664596273291926
80,Ballivor,Meath,53.5329521,-6.968071699999999,370,0,6,14,1826,326,2542,0,Town (Small),384,1826,0.21029572836801752
81,Ballon,Carlow,52.7391042,-6.769783899999999,128,2,0,4,702,192,1028,0,Town (Small),132,704,0.1875
82,Ballyagran,Limerick,52.4018224,-8.782366699999999,14,0,2,0,180,10,206,0,Town (Small),14,180,0.07777777777777778
83,Ballybay,Monaghan,54.1294617,-6.9027864,62,0,14,2,1226,340,1644,0,Town (Small),64,1226,0.052202283849918436
84,Ballybofey-Stranorlar,Donegal,54.80166699999999,-7.774999999999999,662,4,36,4,4648,762,6116,0,Town (Small),666,4652,0.14316423043852106
85,Ballyboghil,Dublin,53.52020599999999,-6.267595399999999,94,6,4,32,804,162,1102,0,Town (Small),126,810,0.15555555555555556
86,Ballybrittas,Laois,53.109028,-7.1374187,60,2,2,14,518,16,612,0,Town (Small),74,520,0.1423076923076923
87,Ballybunion,Kerry,52.51108,-9.670969999999999,34,0,2,10,1234,276,1556,0,Town (Small),44,1234,0.03565640194489465
88,Ballycanew,Wexford,52.6106782,-6.3049672,76,0,6,6,526,90,704,0,Town (Small),82,526,0.155893536121673
89,Ballycannan,Clare,52.70296399999999,-8.649498,30,4,2,0,708,12,756,0,Town (Small),30,712,0.042134831460674156
90,Ballycastle,Mayo,54.2796698,-9.372464299999999,22,0,0,0,150,20,192,0,Town (Small),22,150,0.14666666666666667
91,Ballyclerahan,Tipperary,52.4118971,-7.753067199999999,58,2,10,2,1092,118,1282,0,Town (Small),60,1094,0.054844606946983544
92,Ballyclogh,Cork,52.1673919,-8.742242,42,0,6,2,276,44,370,0,Town (Small),44,276,0.15942028985507245
93,Ballycolla,Laois,52.8825474,-7.446860600000001,4,0,0,0,136,6,146,0,Town (Small),4,136,0.029411764705882353
94,Ballyconnell,Cavan,54.1162175,-7.583954299999999,206,12,10,4,1132,350,1714,0,Town (Small),210,1144,0.18356643356643357
95,Ballycotton,Cork,51.8299148,-8.0097621,38,0,0,0,426,72,536,0,Town (Small),38,426,0.0892018779342723
96,Ballycullane,Wexford,52.2803179,-6.8397818,30,0,2,2,182,34,250,0,Town (Small),32,182,0.17582417582417584
97,Ballycumber,Offaly,53.3264159,-7.686113700000001,16,0,0,0,214,18,248,0,Town (Small),16,214,0.07476635514018691
98,Ballydehob,Cork,51.5644261,-9.463412199999999,22,0,4,0,222,58,306,0,Town (Small),22,222,0.0990990990990991
99,Ballydesmond,Cork,52.1796564,-9.2341524,18,2,12,0,228,28,288,0,Town (Small),18,230,0.0782608695652174
100,Ballyduff,Kerry,52.45455159999999,-9.662905199999999,74,2,0,0,340,62,478,0,Town (Small),74,342,0.21637426900584794
101,Ballyforan,Roscommon,53.4700864,-8.270057999999999,28,0,0,0,184,50,262,0,Town (Small),28,184,0.15217391304347827
102,Ballygar,Galway,53.5238778,-8.3346912,34,2,2,2,554,192,786,0,Town (Small),36,556,0.06474820143884892
103,Ballygarvan,Cork,51.824267,-8.4612549,82,0,4,0,626,114,826,0,Town (Small),82,626,0.13099041533546327
104,Ballygawley,Sligo,54.1920204,-8.4452435,36,0,0,2,356,8,402,0,Town (Small),38,356,0.10674157303370786
105,Ballyhack,Wexford,52.2487468,-6.9640362,12,0,0,0,154,32,198,0,Town (Small),12,154,0.07792207792207792
106,Ballyhahill,Limerick,52.5595432,-9.1944765,24,0,2,0,120,34,180,0,Town (Small),24,120,0.2
107,Ballyhaise,Cavan,54.0473393,-7.315509299999999,124,0,4,2,692,172,994,0,Town (Small),126,692,0.18208092485549132
108,Ballyhale,Kilkenny,52.4669813,-7.2002655,6,0,2,0,182,40,230,0,Town (Small),6,182,0.03296703296703297
109,Ballyhaunis,Mayo,53.7628378,-8.7645957,180,2,12,26,1724,950,2894,0,Town (Small),206,1726,0.11935110081112399
110,Ballyheigue,Kerry,52.3904645,-9.8277419,120,0,2,4,378,42,546,0,Town (Small),124,378,0.328042328042328
111,Ballyhogue,Wexford,52.41432,-6.575349999999999,60,0,0,0,252,22,334,0,Town (Small),60,252,0.23809523809523808
112,Ballyhooly,Cork,52.1452748,-8.3980968,80,0,0,0,606,124,810,0,Town (Small),80,606,0.132013201320132
113,Ballyjamesduff,Cavan,53.8638736,-7.206456199999999,164,2,16,4,2534,1082,3802,0,Town (Small),168,2536,0.06624605678233439
114,Ballyknockan,Wicklow,53.1029934,-6.4959254,56,0,0,0,238,6,300,0,Town (Small),56,238,0.23529411764705882
115,Ballylanders,Limerick,52.37351659999999,-8.3455064,36,0,2,0,266,88,392,0,Town (Small),36,266,0.13533834586466165
116,Ballyliffin,Donegal,55.2784391,-7.3942123,82,0,2,0,374,46,504,0,Town (Small),82,374,0.2192513368983957
117,Ballylinan,Laois,52.94358829999999,-7.0420455,206,2,12,32,1176,148,1576,0,Town (Small),238,1178,0.20203735144312393
118,Ballylongford,Kerry,52.5479992,-9.4788097,66,0,4,0,354,18,442,0,Town (Small),66,354,0.1864406779661017
119,Ballymacarbry,Waterford,52.2670804,-7.717650399999999,24,0,0,0,138,14,176,0,Town (Small),24,138,0.17391304347826086
120,Ballymacoda,Cork,51.89210929999999,-7.9395743,62,2,0,0,218,0,282,0,Town (Small),62,220,0.2818181818181818
121,Ballymahon,Longford,53.5643632,-7.764596399999999,40,2,2,6,1162,524,1736,0,Town (Small),46,1164,0.03951890034364261
122,Ballymore,Westmeath,53.4909131,-7.679746399999999,64,0,8,8,500,50,630,0,Town (Small),72,500,0.144
123,Ballymore Eustace,Kildare,53.1330099,-6.614880899999999,112,0,0,12,600,92,816,0,Town (Small),124,600,0.20666666666666667
124,Ballymote,Sligo,54.08982880000001,-8.5171827,98,4,4,18,1534,364,2022,0,Town (Small),116,1538,0.0754226267880364
125,Ballymurn,Wexford,52.4412829,-6.477046899999999,84,2,2,2,690,78,858,0,Town (Small),86,692,0.12427745664739884
126,Ballynacargy,Westmeath,53.5820789,-7.5364989,28,0,0,0,128,48,204,0,Town (Small),28,128,0.21875
127,Ballynacarrow,Sligo,54.13409679999999,-8.560462,18,0,0,0,256,28,302,0,Town (Small),18,256,0.0703125
128,Ballyneety,Limerick,52.5977547,-8.5490207,36,0,0,2,682,18,738,0,Town (Small),38,682,0.05571847507331378
129,Ballynoe,Cork,51.9472538,-8.4460079,50,0,0,0,208,6,264,0,Town (Small),50,208,0.2403846153846154
130,Ballyoulster,Kildare,53.34146459999999,-6.512193799999999,80,2,2,10,336,60,490,0,Town (Small),90,338,0.26627218934911245
131,Ballyporeen,Tipperary,52.2701094,-8.0992106,42,0,4,2,252,60,360,0,Town (Small),44,252,0.1746031746031746
132,Ballyragget,Kilkenny,52.7888894,-7.3328641,148,0,10,4,952,188,1302,0,Town (Small),152,952,0.15966386554621848
133,Ballyroan,Laois,52.9483991,-7.304667599999998,102,0,6,4,712,64,888,0,Town (Small),106,712,0.14887640449438203
134,Ballyroe,Kildare,52.9578429,-6.9389751,24,0,2,4,160,36,226,0,Town (Small),28,160,0.175
135,Ballysadare,Sligo,54.2121162,-8.5090366,88,4,10,10,2012,272,2396,0,Town (Small),98,2016,0.04861111111111111
136,Ballyshannon,Donegal,54.5029882,-8.1920416,124,2,4,6,1626,514,2276,0,Town (Small),130,1628,0.07985257985257985
137,Ballysimon,Wexford,52.5227528,-6.483686199999999,32,0,12,0,356,40,440,0,Town (Small),32,356,0.0898876404494382
138,Ballyvaughan,Clare,53.1155333,-9.149423299999999,34,0,2,0,94,48,178,0,Town (Small),34,94,0.3617021276595745
139,Balrothery,Dublin,53.2915766,-6.339198199999999,380,10,4,84,2030,498,3006,0,Town (Small),464,2040,0.22745098039215686
140,Baltimore,Cork,51.4843274,-9.3661093,86,2,8,4,272,90,462,0,Town (Small),90,274,0.3284671532846715
141,Baltinglass,Wicklow,52.9407807,-6.710979999999999,104,4,8,12,2014,774,2916,0,Town (Small),116,2018,0.057482656095143705
142,Baltray,Louth,53.7371107,-6.2704904,10,0,0,4,166,2,182,0,Town (Small),14,166,0.08433734939759036
143,Banagher,Offaly,53.1901112,-7.986104900000001,62,0,12,6,1372,586,2038,0,Town (Small),68,1372,0.04956268221574344
144,Bandon,Cork,51.74586679999999,-8.735055299999999,808,18,44,18,7458,1716,10062,0,Town (Small),826,7476,0.1104868913857678
145,Bangor Erris,Mayo,54.14464839999999,-9.7428784,50,0,4,0,266,70,390,0,Town (Small),50,266,0.18796992481203006
146,Bansha,Tipperary,52.4482369,-8.0642959,42,0,0,6,256,62,366,0,Town (Small),48,256,0.1875
147,Banteer,Cork,52.12946059999999,-8.8935092,36,0,2,10,312,50,410,0,Town (Small),46,312,0.14743589743589744
148,Bantry,Cork,51.6800803,-9.452576299999999,102,2,12,2,2240,780,3138,0,Town (Small),104,2242,0.0463871543264942
149,Barndarrig,Wicklow,52.90998,-6.11336,54,0,2,2,256,10,324,0,Town (Small),56,256,0.21875
150,Barntown,Wexford,52.34238800000001,-6.5284919,34,0,0,4,526,26,590,0,Town (Small),38,526,0.07224334600760456
151,Baylin,Westmeath,53.43380999999999,-7.840739999999998,14,0,0,6,340,26,386,0,Town (Small),20,340,0.058823529411764705
152,Bearna,Galway,53.2506642,-9.155134499999999,144,8,10,8,2436,362,2968,0,Town (Small),152,2444,0.062193126022913256
153,Beaufort,Kerry,52.0722344,-9.6392584,26,0,2,2,280,18,328,0,Town (Small),28,280,0.1
154,Beaulieu,Louth,53.7280656,-6.2935757,12,2,6,4,230,12,266,0,Town (Small),16,232,0.06896551724137931
155,Belcarra,Mayo,53.8022746,-9.2141371,12,0,0,0,180,36,228,0,Town (Small),12,180,0.06666666666666667
156,Belgooly,Cork,51.7368994,-8.481586900000002,206,0,2,6,888,140,1242,0,Town (Small),212,888,0.23873873873873874
157,Bellanagare,Roscommon,53.8369829,-8.3815026,12,0,4,0,124,14,154,0,Town (Small),12,124,0.0967741935483871
158,Bellanode,Monaghan,54.266922,-7.0364418,64,0,2,0,484,22,572,0,Town (Small),64,484,0.1322314049586777
159,Bellavary,Mayo,53.89366,-9.15104,20,0,0,0,186,34,240,0,Town (Small),20,186,0.10752688172043011
160,Belmont,Offaly,53.2560708,-7.895165199999999,12,0,0,0,152,14,178,0,Town (Small),12,152,0.07894736842105263
161,Belturbet,Cavan,54.10190559999999,-7.449668,120,0,4,6,1154,306,1590,0,Town (Small),126,1154,0.10918544194107452
162,Bennettsbridge,Kilkenny,52.5923475,-7.1843272,72,0,8,2,600,100,782,0,Town (Small),74,600,0.12333333333333334
163,Birr,Offaly,53.0980052,-7.909688200000001,152,2,24,36,3602,1314,5130,0,Town (Small),188,3604,0.05216426193118757
164,Blacklion,Cavan,54.2920639,-7.875127599999999,8,0,0,4,162,22,196,0,Town (Small),12,162,0.07407407407407407
165,Blackwater,Wexford,52.4473539,-6.346930299999999,60,0,0,2,390,62,514,0,Town (Small),62,390,0.15897435897435896
166,Blarney,Cork,51.9338275,-8.5612438,198,4,2,8,2798,370,3380,0,Town (Small),206,2802,0.07351891506067094
167,Blessington,Wicklow,53.1696579,-6.534068700000001,808,20,16,52,5150,1570,7616,0,Town (Small),860,5170,0.16634429400386846
168,Boherbue,Cork,52.1582386,-9.0684828,8,0,0,0,406,118,532,0,Town (Small),8,406,0.019704433497536946
169,Boherlahan,Tipperary,52.5730161,-7.893562899999999,16,0,2,4,170,20,212,0,Town (Small),20,170,0.11764705882352941
170,Bohola,Mayo,53.9025842,-9.0549945,26,0,0,0,170,10,206,0,Town (Small),26,170,0.15294117647058825
171,Bonniconlon,Mayo,54.10908999999999,-9.03075,12,0,0,0,204,36,252,0,Town (Small),12,204,0.058823529411764705
172,Borris,Carlow,52.6012982,-6.9279771,20,0,4,6,438,164,632,0,Town (Small),26,438,0.0593607305936073
173,Borris-In-Ossory,Laois,52.93917769999999,-7.6310983,104,0,4,6,538,124,776,0,Town (Small),110,538,0.20446096654275092
174,Borrisokane,Tipperary,52.9963736,-8.127325599999999,62,6,2,0,808,330,1208,0,Town (Small),62,814,0.07616707616707617
175,Borrisoleigh,Tipperary,52.7525257,-7.957887599999999,12,2,12,8,662,134,830,0,Town (Small),20,664,0.030120481927710843
176,Boyle,Roscommon,53.9722082,-8.2972756,136,0,14,20,1886,684,2740,0,Town (Small),156,1886,0.08271474019088017
177,Bracknagh,Offaly,53.209205,-7.0981836,28,0,4,4,238,16,290,0,Town (Small),32,238,0.13445378151260504
178,Brannockstown,Kildare,53.1226695,-6.693786599999999,8,4,2,10,254,10,288,0,Town (Small),18,258,0.06976744186046512
179,Bray,Wicklow,53.2006993,-6.110931900000001,4460,170,114,3360,22580,8834,39518,3,Town (Medium),7820,22750,0.34373626373626376
180,Bree,Wexford,52.43517689999999,-6.6087149,34,0,0,2,318,58,412,0,Town (Small),36,318,0.11320754716981132
181,Bridebridge,Cork,51.9271158,-8.4865968,24,2,4,0,204,28,262,0,Town (Small),24,206,0.11650485436893204
182,Bridge End,Donegal,55.0422391,-7.3821884,50,0,4,0,360,52,466,0,Town (Small),50,360,0.1388888888888889
183,Bridgetown,Wexford,52.2302422,-6.549064,80,0,0,0,446,92,618,0,Town (Small),80,446,0.17937219730941703
184,Brittas,Dublin,53.2288212,-6.4432551,26,0,2,4,168,2,202,0,Town (Small),30,168,0.17857142857142858
185,Broadford,Clare,52.8060302,-8.6328674,36,0,4,0,328,56,424,0,Town (Small),36,328,0.10975609756097561
186,Broadford,Limerick,52.34552859999999,-8.9752937,12,0,2,0,194,48,256,0,Town (Small),12,194,0.061855670103092786
187,Brosna,Kerry,52.3125648,-9.267679,16,0,0,0,130,14,160,0,Town (Small),16,130,0.12307692307692308
188,Bruff,Limerick,52.4755485,-8.5474034,106,0,8,4,756,172,1046,0,Town (Small),110,756,0.1455026455026455
189,Bruree,Limerick,52.4243025,-8.6606015,62,0,4,0,600,56,722,0,Town (Small),62,600,0.10333333333333333
190,Bun Na Leaca,Donegal,55.1297357,-8.2804066,148,0,0,0,422,26,596,0,Town (Small),148,422,0.35071090047393366
191,Bunclody,Wexford,52.6550857,-6.652193,52,2,4,12,1474,456,2000,0,Town (Small),64,1476,0.04336043360433604
192,Buncrana,Donegal,55.1365797,-7.4560128,374,0,48,4,6672,1124,8222,0,Town (Small),378,6672,0.05665467625899281
193,Bundoran,Donegal,54.4791416,-8.2779341,122,2,6,12,1906,720,2768,0,Town (Small),134,1908,0.07023060796645703
194,Bunratty,Clare,52.6980379,-8.8148982,36,2,0,2,338,12,390,0,Town (Small),38,340,0.11176470588235295
195,Burnfoot,Donegal,55.0583056,-7.4049447,92,0,6,0,378,10,486,0,Town (Small),92,378,0.24338624338624337
196,Butlersbridge,Cavan,54.0452119,-7.3769588,20,0,4,0,260,46,330,0,Town (Small),20,260,0.07692307692307693
197,Buttevant,Cork,52.2321335,-8.670124699999999,52,2,2,8,836,208,1108,0,Town (Small),60,838,0.07159904534606205
198,Bweeng,Cork,52.0448011,-8.7231577,96,0,4,2,908,82,1092,0,Town (Small),98,908,0.10792951541850221
199,Béal An Mhuirthead,Mayo,54.2238996,-9.9876028,50,0,4,2,854,274,1184,0,Town (Small),52,854,0.06088992974238876
200,Béal Átha An Ghaorthaidh,Cork,51.8507469,-9.232640199999999,2,0,0,0,246,46,294,0,Town (Small),2,246,0.008130081300813009
201,Caherconlish,Limerick,52.5951658,-8.4723577,236,0,2,2,1498,180,1918,0,Town (Small),238,1498,0.1588785046728972
202,Cahir,Tipperary,52.3745296,-7.925246899999999,308,2,12,20,2970,832,4144,0,Town (Small),328,2972,0.11036339165545088
203,Cahirciveen,Kerry,51.9477992,-10.2209047,56,2,2,2,672,372,1106,0,Town (Small),58,674,0.08605341246290801
204,Callan,Kilkenny,52.544567,-7.390170899999999,182,4,6,8,2396,656,3252,0,Town (Small),190,2400,0.07916666666666666
205,Calverstown,Kildare,53.0826121,-6.797989400000001,132,0,2,28,760,20,942,0,Town (Small),160,760,0.21052631578947367
206,Camolin,Wexford,52.6156787,-6.4263356,66,4,10,0,352,64,496,0,Town (Small),66,356,0.1853932584269663
207,Campile,Wexford,52.2881507,-6.9413872,114,0,2,0,262,12,390,0,Town (Small),114,262,0.4351145038167939
208,Cappamore,Limerick,52.6149925,-8.3377813,80,6,6,0,470,166,728,0,Town (Small),80,476,0.16806722689075632
209,Cappawhite,Tipperary,52.5822151,-8.164659000000002,36,0,0,4,334,78,452,0,Town (Small),40,334,0.11976047904191617
210,Cappoquin,Waterford,52.1462713,-7.842743799999999,116,0,4,0,566,162,848,0,Town (Small),116,566,0.2049469964664311
211,Carlanstown,Meath,53.7597065,-6.841353799999999,94,2,6,0,826,138,1066,0,Town (Small),94,828,0.11352657004830918
212,Carlingford,Louth,54.0468677,-6.190181,174,2,4,10,1120,268,1578,0,Town (Small),184,1122,0.16399286987522282
213,Carlow,Carlow,52.835854,-6.932474399999999,1208,122,114,478,22762,7268,31952,3,Town (Medium),1686,22884,0.07367593078133193
214,Carndonagh,Donegal,55.2506229,-7.266890500000001,204,0,22,4,2462,456,3148,0,Town (Small),208,2462,0.08448415922014622
215,Carnew,Wicklow,52.7096658,-6.4992316,32,0,4,10,908,400,1354,0,Town (Small),42,908,0.046255506607929514
216,Carney,Sligo,54.3386704,-8.5277091,118,0,2,4,458,12,594,0,Town (Small),122,458,0.2663755458515284
217,Carragh,Kildare,53.2371324,-6.7289787,188,0,0,92,1018,220,1518,0,Town (Small),280,1018,0.275049115913556
218,Carraig Airt,Donegal,55.1775506,-7.793277699999999,54,0,0,0,204,26,284,0,Town (Small),54,204,0.2647058823529412
219,Carrick-On-Shannon,Leitrim,53.945181,-8.0863766,176,10,14,54,4310,1096,5660,0,Town (Small),230,4320,0.05324074074074074
220,Carrick-on-Suir,Tipperary,52.3467186,-7.414770799999999,584,6,6,14,4312,1232,6154,0,Town (Small),598,4318,0.13849004168596574
221,Carrickmacross,Monaghan,53.9779778,-6.7188238,482,8,38,2,4738,1574,6842,0,Town (Small),484,4746,0.10198061525495154
222,Carrig on Bannow,Wexford,52.2385344,-6.7321656,84,0,2,0,322,50,458,0,Town (Small),84,322,0.2608695652173913
223,Carrigaline,Cork,51.8164452,-8.3912494,1796,58,64,26,20048,3152,25144,3,Town (Medium),1822,20106,0.09061971550780862
224,Carrigallen,Leitrim,53.9769348,-7.644325899999999,10,0,0,6,426,144,586,0,Town (Small),16,426,0.03755868544600939
225,Carrigans,Donegal,54.9512185,-7.428285199999999,54,0,2,2,374,18,450,0,Town (Small),56,374,0.1497326203208556
226,Carrigkerry,Limerick,52.49449,-9.1486153,26,0,0,0,154,20,200,0,Town (Small),26,154,0.16883116883116883
227,Carrignavar,Cork,51.9891078,-8.477924,4,0,2,4,636,114,760,0,Town (Small),8,636,0.012578616352201259
228,Carrigtwohill,Cork,51.9094919,-8.2589402,396,32,12,186,5990,1530,8146,0,Town (Small),582,6022,0.0966456326801727
229,Carrowkeel,Donegal,55.137713,-7.663875699999999,62,0,0,0,274,68,404,0,Town (Small),62,274,0.22627737226277372
230,Cashel,Tipperary,52.51590969999999,-7.8915829,166,4,20,22,3842,1466,5520,0,Town (Small),188,3846,0.048881955278211126
231,Castlebar,Mayo,53.8550014,-9.287925699999999,460,12,46,52,11318,3494,15382,3,Town (Medium),512,11330,0.04518976169461606
232,Castlebellingham-Kilsaran,Louth,53.89811,-6.3895,150,6,4,8,962,134,1264,0,Town (Small),158,968,0.16322314049586778
233,Castleblayney,Monaghan,54.120659,-6.7397374,178,6,24,10,3394,1050,4662,0,Town (Small),188,3400,0.05529411764705883
234,Castlebridge,Wexford,52.3824281,-6.4502872,176,6,4,6,1956,250,2398,0,Town (Small),182,1962,0.09276248725790011
235,Castlecomer,Kilkenny,52.8052843,-7.210312699999998,66,2,0,6,1230,328,1632,0,Town (Small),72,1232,0.05844155844155844
236,Castleconnell,Limerick,52.7129297,-8.500052499999999,350,8,18,16,2466,320,3178,0,Town (Small),366,2474,0.14793856103476152
237,Castledermot,Kildare,52.9118755,-6.837567,62,0,16,18,1506,450,2052,0,Town (Small),80,1506,0.05312084993359894
238,Castlefinn,Donegal,54.802999,-7.5895814,152,0,8,2,514,104,780,0,Town (Small),154,514,0.29961089494163423
239,Castlegregory,Kerry,52.25346510000001,-10.0207218,12,2,4,2,352,62,434,0,Town (Small),14,354,0.03954802259887006
240,Castleisland,Kerry,52.2328974,-9.4601492,84,0,16,4,2208,476,2788,0,Town (Small),88,2208,0.03985507246376811
241,Castlelyons,Cork,52.0885669,-8.233699,70,0,0,0,484,14,568,0,Town (Small),70,484,0.1446280991735537
242,Castlemagner,Cork,51.8985143,-8.4756035,42,0,8,6,452,2,510,0,Town (Small),48,452,0.10619469026548672
243,Castlemaine,Kerry,52.1684322,-9.7014756,6,0,2,0,184,12,204,0,Town (Small),6,184,0.03260869565217391
244,Castlemartyr,Cork,51.9119477,-8.0535486,286,4,10,6,1402,390,2098,0,Town (Small),292,1406,0.20768136557610242
245,Castlepollard,Westmeath,53.6800722,-7.2964508,56,0,6,4,1052,310,1428,0,Town (Small),60,1052,0.057034220532319393
246,Castlerea,Roscommon,53.7686571,-8.4924537,104,6,22,38,1510,336,2016,0,Town (Small),142,1516,0.09366754617414248
247,Castletown,Laois,52.9774693,-7.4995604,46,0,2,4,422,70,544,0,Town (Small),50,422,0.11848341232227488
248,Castletown Geoghegan,Westmeath,53.4462801,-7.487606899999999,38,0,2,4,274,30,348,0,Town (Small),42,274,0.15328467153284672
249,Castletownbere,Cork,51.65149539999999,-9.910330199999999,12,0,4,0,756,384,1156,0,Town (Small),12,756,0.015873015873015872
250,Castletownroche,Cork,52.1731113,-8.4634479,40,0,6,4,384,114,548,0,Town (Small),44,384,0.11458333333333333
251,Castletownshend,Cork,51.5265757,-9.179386899999999,6,0,2,2,126,14,150,0,Town (Small),8,126,0.06349206349206349
252,Causeway,Kerry,52.41442199999999,-9.7330771,2,0,2,0,184,30,218,0,Town (Small),2,184,0.010869565217391304
253,Cavan,Cavan,53.9897186,-7.3633319,846,20,48,26,10680,2234,13854,3,Town (Medium),872,10700,0.08149532710280374
254,Celbridge,Kildare,53.3383911,-6.5397633,3912,124,34,892,16910,5594,27466,3,Town (Medium),4804,17034,0.2820241869202771
255,Charlestown-Bellahy,Mayo,53.964167,-8.795278,54,0,12,2,1072,322,1462,0,Town (Small),56,1072,0.05223880597014925
256,Charleville,Cork,52.3556889,-8.6840314,182,10,16,12,3144,968,4332,0,Town (Small),194,3154,0.061509194673430564
257,Cheekpoint,Waterford,52.2698641,-7.0009247,20,0,6,4,242,10,282,0,Town (Small),24,242,0.09917355371900827
258,Churchtown,Cork,52.2713057,-8.730869199999999,60,0,0,16,570,162,808,0,Town (Small),76,570,0.13333333333333333
259,Cill Charthaigh,Donegal,54.6323944,-8.5894621,54,0,2,0,344,50,450,0,Town (Small),54,344,0.1569767441860465
260,Cill Rónáin,Galway,53.1232125,-9.670372799999999,16,0,4,2,114,96,232,0,Town (Small),18,114,0.15789473684210525
261,Clane,Kildare,53.293785,-6.6870404,946,24,18,178,7760,2064,10990,0,Town (Small),1124,7784,0.14439876670092497
262,Clara,Offaly,53.3425103,-7.613480099999999,184,4,14,80,3092,654,4028,0,Town (Small),264,3096,0.08527131782945736
263,Claremorris,Mayo,53.72387639999999,-9.0017356,474,16,6,26,3320,736,4578,0,Town (Small),500,3336,0.1498800959232614
264,Clarina,Limerick,52.63209,-8.73269,42,0,2,0,682,36,762,0,Town (Small),42,682,0.06158357771260997
265,Clarinbridge,Galway,53.2293077,-8.8773824,112,0,4,8,994,88,1206,0,Town (Small),120,994,0.12072434607645875
266,Clashmore,Waterford,52.0093569,-7.8188756,54,2,0,0,256,46,358,0,Town (Small),54,258,0.20930232558139536
267,Clifden,Galway,53.4891345,-10.0202388,64,0,6,6,712,504,1292,0,Town (Small),70,712,0.09831460674157304
268,Cliffony,Sligo,54.430559,-8.453432399999999,52,2,6,0,454,58,572,0,Town (Small),52,456,0.11403508771929824
269,Clogh,Kilkenny,52.8710161,-7.1642467,42,0,4,2,274,14,336,0,Town (Small),44,274,0.16058394160583941
270,Cloghan,Offaly,53.2252399,-7.8825143,76,0,8,2,590,74,750,0,Town (Small),78,590,0.13220338983050847
271,Clogheen,Tipperary,52.2770794,-7.9951028,60,4,0,0,418,62,544,0,Town (Small),60,422,0.14218009478672985
272,Clogherhead,Louth,53.7916777,-6.2388506,482,2,22,36,2056,518,3116,0,Town (Small),518,2058,0.25170068027210885
273,Cloghfin,Donegal,54.653827,-8.1096142,20,0,0,0,120,4,144,0,Town (Small),20,120,0.16666666666666666
274,Clonakilty,Cork,51.6203379,-8.905510399999999,204,10,12,8,4000,1796,6030,0,Town (Small),212,4010,0.05286783042394015
275,Clonard,Meath,53.4515329,-7.0231073,78,2,2,6,326,24,438,0,Town (Small),84,328,0.25609756097560976
276,Clonaslee,Laois,53.1486014,-7.524369599999999,20,2,4,4,632,84,746,0,Town (Small),24,634,0.03785488958990536
277,Clonbullogue,Offaly,53.26068309999999,-7.086431,46,2,2,6,314,58,428,0,Town (Small),52,316,0.16455696202531644
278,Clondrohid,Cork,51.9292332,-9.022767499999999,22,0,2,0,212,18,254,0,Town (Small),22,212,0.10377358490566038
279,Clondulane,Cork,52.1421634,-8.2203365,4,2,2,0,554,96,658,0,Town (Small),4,556,0.007194244604316547
280,Clonee,Meath,53.4105621,-6.4426,200,16,2,48,1060,200,1526,0,Town (Small),248,1076,0.23048327137546468
281,Clonegall,Carlow,52.6948009,-6.6477303,10,0,6,0,202,60,278,0,Town (Small),10,202,0.04950495049504951
282,Clones,Monaghan,54.1796829,-7.230667100000001,72,2,10,4,1258,818,2164,0,Town (Small),76,1260,0.06031746031746032
283,Clongeen,Wexford,52.2978897,-6.7727531,46,0,0,2,212,22,282,0,Town (Small),48,212,0.22641509433962265
284,Clonlara,Clare,52.7238329,-8.5528365,52,0,4,2,840,118,1016,0,Town (Small),54,840,0.06428571428571428
285,Clonmany,Donegal,55.2628052,-7.411610800000001,104,0,6,2,438,58,608,0,Town (Small),106,438,0.2420091324200913
286,Clonmel,Tipperary,52.3623523,-7.7007084,756,50,46,32,16448,3590,20922,3,Town (Medium),788,16498,0.04776336525639471
287,Clonmellon,Westmeath,53.6640717,-7.0183933,102,0,8,4,670,136,920,0,Town (Small),106,670,0.1582089552238806
288,Clonroche,Wexford,52.4496872,-6.7174157,30,0,0,0,212,62,304,0,Town (Small),30,212,0.14150943396226415
289,Clontibret,Monaghan,54.2054431,-6.8415402,40,0,0,2,216,32,290,0,Town (Small),42,216,0.19444444444444445
290,Clonygowan,Offaly,53.1874518,-7.2804446,32,0,4,20,306,74,436,0,Town (Small),52,306,0.16993464052287582
291,Cloonfad,Roscommon,53.6867556,-8.75182,26,0,6,0,378,70,480,0,Town (Small),26,378,0.06878306878306878
292,Cloontuskert,Roscommon,53.70606859999999,-8.0028889,10,2,0,2,180,16,210,0,Town (Small),12,182,0.06593406593406594
293,Cloughduv,Cork,51.8473203,-8.7880041,68,0,2,0,450,88,608,0,Town (Small),68,450,0.1511111111111111
294,Cloughjordan,Tipperary,52.9429442,-8.0383372,128,2,8,14,392,228,772,0,Town (Small),142,394,0.3604060913705584
295,Cloyne,Cork,51.8630971,-8.121236999999999,306,12,12,30,1926,388,2674,0,Town (Small),336,1938,0.17337461300309598
296,Cluain Bú,Galway,53.5137007,-8.6601381,88,0,4,0,498,8,598,0,Town (Small),88,498,0.17670682730923695
297,Coachford,Cork,51.909471,-8.788960099999999,12,0,2,0,416,140,570,0,Town (Small),12,416,0.028846153846153848
298,Cobh,Cork,51.8530415,-8.295090499999999,1398,30,116,606,12322,3338,17810,3,Town (Medium),2004,12352,0.16224093264248704
299,Coill Dubh (Blackwood),Kildare,53.2931573,-6.818584400000001,234,6,4,10,1402,198,1854,0,Town (Small),244,1408,0.17329545454545456
300,Collinstown,Westmeath,53.64747149999999,-7.212159999999999,36,2,0,0,304,66,408,0,Town (Small),36,306,0.11764705882352941
301,Collon,Louth,53.7777425,-6.4840991,242,0,2,4,732,188,1168,0,Town (Small),246,732,0.3360655737704918
302,Collooney,Sligo,54.1849522,-8.4865545,146,0,2,12,1894,346,2400,0,Town (Small),158,1894,0.08342133051742344
303,Conna,Cork,52.0931079,-8.1073545,118,0,4,0,542,96,760,0,Town (Small),118,542,0.2177121771217712
304,Convoy,Donegal,54.859725,-7.6654466,196,0,6,0,1484,182,1868,0,Town (Small),196,1484,0.1320754716981132
305,Coolaney,Sligo,54.17380929999999,-8.6008023,164,4,6,6,1478,42,1700,0,Town (Small),170,1482,0.11470985155195682
306,Coolboy,Wicklow,52.7620319,-6.462780299999999,54,0,2,0,314,6,376,0,Town (Small),54,314,0.17197452229299362
307,Coolgreany,Wexford,52.7647077,-6.2360077,30,4,6,4,356,40,440,0,Town (Small),34,360,0.09444444444444444
308,Cootehall,Roscommon,53.9841688,-8.1580069,52,2,4,2,300,2,362,0,Town (Small),54,302,0.17880794701986755
309,Cootehill,Cavan,54.0725034,-7.0823541,234,0,6,2,1564,416,2222,0,Town (Small),236,1564,0.15089514066496162
310,Cork city and suburbs,Cork,51.8985143,-8.4756035,25718,868,648,1218,170530,59804,258786,4,City (Large),26936,171398,0.15715469258684464
311,Corofin,Clare,52.9448216,-9.0640874,158,0,0,2,676,76,912,0,Town (Small),160,676,0.23668639053254437
312,Corrandulla,Galway,53.3991608,-8.995794499999999,70,2,0,0,400,74,546,0,Town (Small),70,402,0.17412935323383086
313,Corrofin,Galway,53.437565,-8.8602715,158,0,4,2,906,14,1084,0,Town (Small),160,906,0.17660044150110377
314,Courtbrack,Cork,51.8808748,-8.4785161,26,0,4,0,676,0,706,0,Town (Small),26,676,0.038461538461538464
315,Courtmacsherry,Cork,51.63385539999999,-8.7059339,118,0,2,2,508,38,668,0,Town (Small),120,508,0.23622047244094488
316,Courtown,Wexford,52.6448624,-6.2286169,676,4,22,28,3416,548,4694,0,Town (Small),704,3420,0.20584795321637428
317,Cratloe,Clare,52.6985433,-8.762853699999999,52,4,4,2,910,44,1016,0,Town (Small),54,914,0.05908096280087528
318,Craughwell,Galway,53.2302689,-8.7347736,162,0,6,10,1250,38,1466,0,Town (Small),172,1250,0.1376
319,Creeslough,Donegal,55.12334970000001,-7.909467599999999,64,0,0,0,266,68,398,0,Town (Small),64,266,0.24060150375939848
320,Crinkill,Offaly,53.07837860000001,-7.8970751,28,0,0,6,728,158,920,0,Town (Small),34,728,0.046703296703296704
321,Cromane,Kerry,52.1061221,-9.898534699999999,4,0,0,0,222,16,242,0,Town (Small),4,222,0.018018018018018018
322,Crookstown,Cork,51.84242700000001,-8.830431899999999,32,0,0,0,194,8,234,0,Town (Small),32,194,0.16494845360824742
323,Croom,Limerick,52.519036,-8.7174345,26,2,0,0,658,266,952,0,Town (Small),26,660,0.03939393939393939
324,Crossakeel,Meath,53.71411920000001,-7.020536799999999,30,0,0,2,230,8,270,0,Town (Small),32,230,0.1391304347826087
325,Crossbarry,Cork,51.8020473,-8.6453657,156,0,4,0,434,4,598,0,Town (Small),156,434,0.35944700460829493
326,Crosshaven,Cork,51.8022632,-8.2904494,222,10,12,6,3290,610,4150,0,Town (Small),228,3300,0.06909090909090909
327,Crossmolina,Mayo,54.100342,-9.3158456,24,2,4,0,1126,166,1322,0,Town (Small),24,1128,0.02127659574468085
328,Crusheen,Clare,52.9386532,-8.8967688,60,2,2,4,786,88,942,0,Town (Small),64,788,0.08121827411167512
329,Culdaff,Donegal,55.2859437,-7.165135100000001,54,2,2,2,352,24,436,0,Town (Small),56,354,0.15819209039548024
330,Curragh Camp,Kildare,53.1474495,-6.8299723,126,6,4,18,974,102,1230,0,Town (Small),144,980,0.1469387755102041
331,Cut Bush,Kildare,53.1237168,-6.8326039,48,0,2,12,306,58,426,0,Town (Small),60,306,0.19607843137254902
332,Daingean,Offaly,53.2960818,-7.291967,182,4,10,22,1048,198,1464,0,Town (Small),204,1052,0.19391634980988592
333,Delvin,Westmeath,53.6125653,-7.0917224,134,2,4,6,608,62,816,0,Town (Small),140,610,0.22950819672131148
334,Derrinturn,Kildare,53.3395275,-6.9399818,402,0,10,18,1638,346,2414,0,Town (Small),420,1638,0.2564102564102564
335,Dingle-Daingean Uí Chuis,Kerry,52.1408534,-10.2671142,42,8,8,12,804,718,1592,0,Town (Small),54,812,0.0665024630541872
336,Doirí Beaga,Donegal,55.0743448,-8.294187299999999,52,0,6,0,622,72,752,0,Town (Small),52,622,0.08360128617363344
337,Donabate,Dublin,53.4853365,-6.1504482,812,40,18,2780,6622,3226,13498,0,Town (Small),3592,6662,0.5391774241969378
338,Donard,Wicklow,53.0222351,-6.6130978,24,0,2,0,204,48,278,0,Town (Small),24,204,0.11764705882352941
339,Donaskeigh,Tipperary,52.5218302,-8.0647868,18,0,4,0,188,10,220,0,Town (Small),18,188,0.09574468085106383
340,Donegal,Donegal,54.653827,-8.1096142,84,6,14,2,2324,524,2954,0,Town (Small),86,2330,0.03690987124463519
341,Doneraile,Cork,52.2151735,-8.585977399999999,14,2,2,8,742,178,946,0,Town (Small),22,744,0.02956989247311828
342,Donore,Meath,53.6921097,-6.4172506,140,2,0,10,698,178,1028,0,Town (Small),150,700,0.21428571428571427
343,Doohamlat,Monaghan,54.1287354,-6.823994600000001,32,0,0,0,292,64,388,0,Town (Small),32,292,0.1095890410958904
344,Doon,Limerick,52.6043221,-8.248491699999999,16,2,8,2,600,164,792,0,Town (Small),18,602,0.029900332225913623
345,Doonbeg,Clare,52.7308501,-9.5259951,22,0,2,0,182,60,266,0,Town (Small),22,182,0.12087912087912088
346,Drangan,Tipperary,52.5170482,-7.583662700000001,8,0,4,0,132,10,154,0,Town (Small),8,132,0.06060606060606061
347,Drimoleague,Cork,51.6599357,-9.261245299999999,48,0,2,0,438,68,556,0,Town (Small),48,438,0.1095890410958904
348,Drogheda,Louth,53.717856,-6.3560985,6686,136,126,1208,31176,13690,53022,3,Town (Medium),7894,31312,0.2521078180889116
349,Dromahair,Leitrim,54.2306704,-8.3026235,90,2,0,0,964,178,1234,0,Town (Small),90,966,0.09316770186335403
350,Dromina,Cork,52.3117507,-8.8012075,14,0,2,0,298,44,358,0,Town (Small),14,298,0.04697986577181208
351,Dromineer,Tipperary,52.9248849,-8.2756534,0,0,0,0,80,6,86,0,Town (Small),0,80,0.0
352,Dromiskin,Louth,53.9217123,-6.401009200000001,188,4,2,8,1318,150,1670,0,Town (Small),196,1322,0.14826021180030258
353,Drommahane,Cork,52.1056038,-8.6908349,78,2,10,18,960,196,1264,0,Town (Small),96,962,0.0997920997920998
354,Dromore West,Sligo,54.2495094,-8.8799262,70,0,4,0,270,20,364,0,Town (Small),70,270,0.25925925925925924
355,Drumcollogher,Limerick,52.3396079,-8.9076419,4,0,8,2,436,100,550,0,Town (Small),6,436,0.013761467889908258
356,Drumconrath,Meath,53.8515966,-6.6563415,76,0,6,2,326,60,470,0,Town (Small),78,326,0.2392638036809816
357,Drumkeen,Donegal,54.8660308,-7.7513945,38,2,4,0,366,22,432,0,Town (Small),38,368,0.10326086956521739
358,Drumkeeran,Leitrim,54.16940899999999,-8.142664,6,0,0,2,184,70,262,0,Town (Small),8,184,0.043478260869565216
359,Drumlish,Longford,53.82059030000001,-7.768414,230,0,18,18,976,172,1414,0,Town (Small),248,976,0.2540983606557377
360,Drumod,Leitrim,53.8575697,-7.9208348,156,4,2,26,668,30,886,0,Town (Small),182,672,0.2708333333333333
361,Drumshanbo,Leitrim,54.04780040000001,-8.0400238,40,0,6,12,1028,238,1324,0,Town (Small),52,1028,0.05058365758754864
362,Drumsna,Leitrim,53.9269176,-8.0079271,44,2,0,2,272,2,322,0,Town (Small),46,274,0.1678832116788321
363,Duagh,Kerry,52.4147893,-9.3901918,22,0,4,0,292,44,362,0,Town (Small),22,292,0.07534246575342465
364,Dublin city and suburbs,Dublin,53.3498053,-6.2603097,225800,9312,2960,104860,689012,440362,1472306,1,City (Large),330660,698324,0.4735051351521643
365,Duleek,Meath,53.6547501,-6.4221752,1450,8,14,46,4580,358,6456,0,Town (Small),1496,4588,0.3260680034873583
366,Dumha Thuama,Mayo,54.0645,-9.5357,34,0,0,2,60,4,100,0,Town (Small),36,60,0.6
367,Dunboyne,Meath,53.4192677,-6.4758857,742,32,32,528,5740,2594,9668,0,Town (Small),1270,5772,0.22002772002772003
368,Duncannon,Wexford,52.2206117,-6.9325606,12,0,0,2,192,34,240,0,Town (Small),14,192,0.07291666666666667
369,Duncormick,Wexford,52.2285412,-6.655054199999999,26,0,0,0,178,12,216,0,Town (Small),26,178,0.14606741573033707
370,Dundalk,Louth,53.9979451,-6.405957,4392,110,84,440,31450,11704,48180,3,Town (Medium),4832,31560,0.15310519645120405
371,Dunderrow,Cork,51.726487,-8.5874569,30,0,0,0,216,70,316,0,Town (Small),30,216,0.1388888888888889
372,Dundrum,Tipperary,52.5595234,-8.043225099999999,56,0,0,0,188,28,272,0,Town (Small),56,188,0.2978723404255319
373,Dunfanaghy,Donegal,55.1834711,-7.9694369,52,0,2,0,318,68,440,0,Town (Small),52,318,0.16352201257861634
374,Dungarvan,Waterford,52.0936763,-7.620362699999999,326,12,30,14,7846,3138,11366,0,Town (Small),340,7858,0.04326800712649529
375,Dunhill,Waterford,52.1737783,-7.263755799999999,28,2,2,0,244,34,310,0,Town (Small),28,246,0.11382113821138211
376,Dunkineely,Donegal,54.6320711,-8.357078699999999,58,0,2,0,288,36,384,0,Town (Small),58,288,0.2013888888888889
377,Dunlavin,Wicklow,53.0578764,-6.7016395,14,4,4,0,828,340,1190,0,Town (Small),14,832,0.016826923076923076
378,Dunleer,Louth,53.8310533,-6.3944559,202,4,14,10,1772,682,2684,0,Town (Small),212,1776,0.11936936936936937
379,Dunmanway,Cork,51.7222571,-9.1118088,62,2,10,6,1636,446,2162,0,Town (Small),68,1638,0.04151404151404151
380,Dunmore,Galway,53.6180163,-8.7441461,26,0,2,0,556,208,792,0,Town (Small),26,556,0.046762589928057555
381,Dunmore East,Waterford,52.1527666,-6.994803999999999,228,0,6,10,1632,232,2108,0,Town (Small),238,1632,0.14583333333333334
382,Dunshaughlin,Meath,53.5135229,-6.540252499999999,820,14,18,116,5936,2000,8904,0,Town (Small),936,5950,0.1573109243697479
383,Durrow,Laois,52.84622479999999,-7.394980200000001,144,0,10,12,784,156,1106,0,Town (Small),156,784,0.1989795918367347
384,Durrus,Cork,51.6217112,-9.521993,54,0,2,0,312,54,422,0,Town (Small),54,312,0.17307692307692307
385,Easky,Sligo,54.286325,-8.9623692,16,0,2,0,182,40,240,0,Town (Small),16,182,0.08791208791208792
386,Edenderry,Offaly,53.3432235,-7.0517202,672,22,24,34,6330,2434,9516,0,Town (Small),706,6352,0.11114609571788413
387,Edgeworthstown,Longford,53.6956862,-7.608492999999999,406,2,2,72,1280,458,2220,0,Town (Small),478,1282,0.37285491419656785
388,Elphin,Roscommon,53.8522697,-8.1978488,34,2,4,10,546,174,770,0,Town (Small),44,548,0.08029197080291971
389,Emly,Tipperary,52.4633291,-8.3498992,34,0,0,2,298,52,386,0,Town (Small),36,298,0.12080536912751678
390,Emo,Laois,53.097203,-7.208534999999999,40,2,2,6,242,32,324,0,Town (Small),46,244,0.1885245901639344
391,Emyvale,Monaghan,54.3409914,-6.959261199999999,108,0,6,0,580,86,780,0,Town (Small),108,580,0.18620689655172415
392,Enfield,Meath,53.4142026,-6.8296541,776,12,8,146,2992,1242,5176,0,Town (Small),922,3004,0.30692410119840213
393,Ennis,Clare,52.8474255,-8.988738399999999,1002,58,70,246,26250,5554,33180,3,Town (Medium),1248,26308,0.047438041660331456
394,Enniscorthy,Wexford,52.5031135,-6.5727721,732,18,38,30,9258,2958,13034,0,Town (Small),762,9276,0.08214747736093143
395,Enniscrone,Sligo,54.2136818,-9.090835199999999,36,0,2,12,1022,264,1336,0,Town (Small),48,1022,0.046966731898238745
396,Enniskerry,Wicklow,53.1935037,-6.1707299,216,14,14,106,1788,166,2304,0,Town (Small),322,1802,0.17869034406215317
397,Ennistimon,Clare,52.940372,-9.2934951,22,6,4,4,780,400,1216,0,Town (Small),26,786,0.03307888040712468
398,Errill,Laois,52.8599496,-7.6769934,34,0,4,0,196,14,248,0,Town (Small),34,196,0.17346938775510204
399,Eyrecourt,Galway,53.1997171,-8.131427,36,0,2,4,172,36,250,0,Town (Small),40,172,0.23255813953488372
400,Fahan,Donegal,55.0876125,-7.4724123,66,0,2,0,504,14,586,0,Town (Small),66,504,0.13095238095238096
401,Farran,Cork,51.8733225,-8.720434299999999,28,0,4,0,356,24,412,0,Town (Small),28,356,0.07865168539325842
402,Feakle,Clare,52.9260682,-8.6486521,10,0,0,0,72,20,102,0,Town (Small),10,72,0.1388888888888889
403,Fedamore,Limerick,52.54550709999999,-8.6016177,46,0,0,0,414,14,474,0,Town (Small),46,414,0.1111111111111111
404,Fenit,Kerry,52.2784045,-9.8612114,28,0,4,4,630,68,734,0,Town (Small),32,630,0.050793650793650794
405,Fennagh,Carlow,52.71467,-6.84615,130,0,4,4,474,20,632,0,Town (Small),134,474,0.28270042194092826
406,Ferbane,Offaly,53.27195,-7.8278719,28,2,4,12,1148,214,1408,0,Town (Small),40,1150,0.034782608695652174
407,Fermoy,Cork,52.1378017,-8.2752606,286,22,20,10,5744,1994,8076,0,Town (Small),296,5766,0.05133541449878599
408,Ferns,Wexford,52.5909249,-6.498010499999999,196,2,6,0,932,300,1436,0,Town (Small),196,934,0.20985010706638116
409,Fethard,Tipperary,52.4659436,-7.6927334,94,0,10,8,1496,356,1964,0,Town (Small),102,1496,0.06818181818181818
410,Fethard,Wexford,52.1923021,-6.8402183,64,0,0,0,286,28,378,0,Town (Small),64,286,0.22377622377622378
411,Fiddown,Kilkenny,52.331516,-7.313796000000001,42,0,2,0,514,20,578,0,Town (Small),42,514,0.08171206225680934
412,Fieries,Kerry,52.17019,-9.59718,124,2,6,0,630,154,916,0,Town (Small),124,632,0.1962025316455696
413,Foxford,Mayo,53.98077259999999,-9.113245,62,0,4,6,1256,200,1528,0,Town (Small),68,1256,0.054140127388535034
414,Foynes,Limerick,52.6102719,-9.104861699999999,46,0,0,0,446,78,570,0,Town (Small),46,446,0.1031390134529148
415,Freemount,Cork,52.2768369,-8.8847534,28,0,0,0,274,44,346,0,Town (Small),28,274,0.10218978102189781
416,Frenchpark,Roscommon,53.8695107,-8.4074282,60,0,6,4,392,76,538,0,Town (Small),64,392,0.16326530612244897
417,Freshford,Kilkenny,52.73250669999999,-7.3981631,84,2,8,0,406,84,584,0,Town (Small),84,408,0.20588235294117646
418,Galbally,Limerick,52.4000202,-8.2936733,32,0,2,4,194,36,268,0,Town (Small),36,194,0.18556701030927836
419,Galway city and suburbs,Galway,53.274001,-9.051266199999999,11670,316,208,380,57788,29600,99962,2,Town (Large),12050,58104,0.2073867547845243
420,Garristown,Dublin,53.5668673,-6.3835624,244,2,0,6,522,88,862,0,Town (Small),250,524,0.4770992366412214
421,Geashill,Offaly,53.2352224,-7.3209776,64,2,2,8,310,94,480,0,Town (Small),72,312,0.23076923076923078
422,Glanworth,Cork,52.1866296,-8.3567369,84,2,0,6,576,122,790,0,Town (Small),90,578,0.15570934256055363
423,Glaslough,Monaghan,54.31727840000001,-6.8971168,46,0,4,2,430,38,520,0,Town (Small),48,430,0.11162790697674418
424,Glassan,Westmeath,53.4699107,-7.863907299999999,16,0,0,8,214,18,256,0,Town (Small),24,214,0.11214953271028037
425,Gleann Cholm Cille,Donegal,54.7080885,-8.7295157,14,0,0,0,110,38,162,0,Town (Small),14,110,0.12727272727272726
426,Glenamaddy,Galway,53.6055461,-8.5604032,32,0,8,0,414,214,668,0,Town (Small),32,414,0.07729468599033816
427,Glenbeigh,Kerry,52.0561861,-9.9403477,32,2,0,2,354,36,426,0,Town (Small),34,356,0.09550561797752809
428,Glencullen,Dublin,53.2224638,-6.216138,18,2,2,34,408,38,502,0,Town (Small),52,410,0.12682926829268293
429,Glenealy,Wicklow,52.9666341,-6.144572900000001,102,4,10,10,612,72,810,0,Town (Small),112,616,0.18181818181818182
430,Gleneely,Donegal,55.2387477,-7.1466476,36,0,4,0,216,38,294,0,Town (Small),36,216,0.16666666666666666
431,Glengarriff,Cork,51.7500277,-9.5522224,34,0,0,2,142,42,220,0,Town (Small),36,142,0.2535211267605634
432,Glenties,Donegal,54.7971669,-8.2830316,30,0,6,0,802,196,1034,0,Town (Small),30,802,0.03740648379052369
433,Glenville,Cork,52.04565789999999,-8.4254293,130,2,4,0,568,102,806,0,Town (Small),130,570,0.22807017543859648
434,Glin,Limerick,52.5688921,-9.2819067,56,0,0,0,508,122,686,0,Town (Small),56,508,0.11023622047244094
435,Gneevgullia,Kerry,52.1166851,-9.2719471,50,0,6,2,320,32,410,0,Town (Small),52,320,0.1625
436,Gob an Choire,Mayo,53.9302564,-9.9266332,8,0,0,0,168,52,228,0,Town (Small),8,168,0.047619047619047616
437,Golden,Tipperary,52.4984411,-7.980749500000001,36,0,6,8,334,42,426,0,Town (Small),44,334,0.1317365269461078
438,Goresbridge,Kilkenny,52.6297084,-6.9940878,22,0,0,6,248,44,320,0,Town (Small),28,248,0.11290322580645161
439,Gorey,Wexford,52.67573549999999,-6.2943022,796,26,28,104,9662,3736,14352,0,Town (Small),900,9688,0.09289843104872006
440,Gormanston,Meath,53.6419159,-6.2480288,28,0,0,20,284,24,356,0,Town (Small),48,284,0.16901408450704225
441,Gort,Galway,53.0666432,-8.8187486,174,2,4,30,2222,678,3110,0,Town (Small),204,2224,0.09172661870503597
442,Gort An Choirce,Donegal,55.116926,-8.140072500000002,28,0,4,0,280,46,358,0,Town (Small),28,280,0.1
443,Gortnahoo,Tipperary,52.6759449,-7.602561799999999,46,0,6,0,242,64,358,0,Town (Small),46,242,0.19008264462809918
444,Gowran,Kilkenny,52.6290523,-7.0665112,116,0,6,4,784,130,1040,0,Town (Small),120,784,0.15306122448979592
445,Graiguenamanagh-Tinnahinch,Kilkenny,52.54413479999999,-6.9594397,82,6,2,14,976,282,1362,0,Town (Small),96,982,0.09775967413441955
446,Granard,Longford,53.7791755,-7.4923774,28,0,4,2,614,388,1036,0,Town (Small),30,614,0.048859934853420196
447,Grange,Sligo,54.3932789,-8.5220973,40,0,0,2,532,198,772,0,Town (Small),42,532,0.07894736842105263
448,Greencastle,Donegal,55.203361,-6.9875478,158,4,10,4,1194,84,1454,0,Town (Small),162,1198,0.1352253756260434
449,Grenagh,Cork,52.0104774,-8.610667,106,0,2,0,934,28,1070,0,Town (Small),106,934,0.11349036402569593
450,Greystones-Delgany,Wicklow,53.1491175,-6.0793414,1972,104,78,2674,17024,4688,26540,3,Town (Medium),4646,17128,0.27125175151798225
451,Gurteen,Sligo,53.99590019999999,-8.5226889,50,0,2,2,412,78,544,0,Town (Small),52,412,0.1262135922330097
452,Hacketstown,Carlow,52.8653857,-6.5586053,12,0,6,0,486,224,728,0,Town (Small),12,486,0.024691358024691357
453,Halfway,Cork,51.80401999999999,-8.57161,32,0,6,0,328,0,366,0,Town (Small),32,328,0.0975609756097561
454,Headford,Galway,53.4694617,-9.106133999999999,58,0,12,0,1222,220,1512,0,Town (Small),58,1222,0.04746317512274959
455,Holycross,Tipperary,52.6397686,-7.870179299999998,54,0,0,26,716,48,844,0,Town (Small),80,716,0.11173184357541899
456,Hospital,Limerick,52.4743003,-8.4324543,36,0,2,2,550,182,772,0,Town (Small),38,550,0.06909090909090909
457,Inagh,Clare,52.8769834,-9.176764499999999,18,0,2,0,214,18,252,0,Town (Small),18,214,0.08411214953271028
458,Inchigeelagh,Cork,51.8424464,-9.1264323,6,0,0,0,128,20,154,0,Town (Small),6,128,0.046875
459,Inishannon,Cork,51.7649008,-8.6574773,144,4,2,0,1066,248,1464,0,Town (Small),144,1070,0.13457943925233645
460,Inistioge,Kilkenny,52.4884908,-7.065458899999999,44,0,0,0,236,40,320,0,Town (Small),44,236,0.1864406779661017
461,Inniskeen,Monaghan,54.00315999999999,-6.58406,50,2,8,0,316,72,448,0,Town (Small),50,318,0.15723270440251572
462,Irishtown,Mayo,53.6627806,-8.8900518,22,0,6,0,168,32,228,0,Town (Small),22,168,0.13095238095238096
463,Jenkinstown,Louth,54.01605559999999,-6.3103519,86,0,6,8,416,2,518,0,Town (Small),94,416,0.22596153846153846
464,Johnstown,Kildare,53.2370579,-6.6217975,458,0,4,24,1412,88,1986,0,Town (Small),482,1412,0.3413597733711048
465,Johnstown,Kilkenny,52.74851779999999,-7.556992999999999,20,2,0,0,358,88,468,0,Town (Small),20,360,0.05555555555555555
466,Johnstownbridge,Kildare,53.4019965,-6.855203299999999,160,0,4,20,610,108,902,0,Town (Small),180,610,0.29508196721311475
467,Julianstown,Meath,53.6729374,-6.285651,146,2,0,26,650,114,938,0,Town (Small),172,652,0.26380368098159507
468,Kanturk,Cork,52.17725489999999,-8.9051669,152,2,18,28,2498,668,3366,0,Town (Small),180,2500,0.072
469,Keadew,Roscommon,54.0511423,-8.1377557,22,0,2,4,168,14,210,0,Town (Small),26,168,0.15476190476190477
470,Keel-Dooagh,Mayo,53.9749643,-10.1266688,52,0,2,2,356,56,468,0,Town (Small),54,356,0.15168539325842698
471,Keenagh,Longford,53.622007,-7.8147206,162,0,2,8,640,136,948,0,Town (Small),170,640,0.265625
472,Kells,Kilkenny,52.5396697,-7.273187099999999,32,0,2,2,346,26,408,0,Town (Small),34,346,0.09826589595375723
473,Kells,Meath,53.72718030000001,-6.876972299999999,884,16,20,8,5138,1700,7766,0,Town (Small),892,5154,0.17306946061311604
474,Kenmare,Kerry,51.8801017,-9.583520199999999,74,4,8,8,1982,732,2808,0,Town (Small),82,1986,0.041289023162134945
475,Kentstown,Meath,53.6275364,-6.533341099999999,312,2,4,0,1126,204,1648,0,Town (Small),312,1128,0.2765957446808511
476,Kernanstown,Carlow,52.835854,-6.932474399999999,6,0,0,2,218,28,254,0,Town (Small),8,218,0.03669724770642202
477,Keshcarrigan,Leitrim,54.0188646,-7.942526399999999,42,0,0,4,188,12,246,0,Town (Small),46,188,0.24468085106382978
478,Kilbeggan,Westmeath,53.3684574,-7.4994634,60,2,12,8,1288,434,1804,0,Town (Small),68,1290,0.05271317829457364
479,Kilberry,Kildare,53.0311398,-7.016986999999999,36,0,4,4,290,22,356,0,Town (Small),40,290,0.13793103448275862
480,Kilbrin,Cork,51.8812776,-8.4408691,18,0,2,0,186,26,232,0,Town (Small),18,186,0.0967741935483871
481,Kilbrittain,Cork,51.6735577,-8.6917337,34,0,2,0,216,46,298,0,Town (Small),34,216,0.1574074074074074
482,Kilcloon,Meath,53.42723,-6.58392,42,2,2,30,456,62,594,0,Town (Small),72,458,0.1572052401746725
483,Kilcock,Kildare,53.3994266,-6.6681233,976,38,20,696,7518,2534,11782,0,Town (Small),1672,7556,0.22128110111169932
484,Kilcolgan,Galway,53.210233,-8.869438299999999,26,0,2,2,226,26,282,0,Town (Small),28,226,0.12389380530973451
485,Kilcoole,Wicklow,53.1062723,-6.064586100000001,536,20,14,300,3924,1146,5940,0,Town (Small),836,3944,0.21196754563894524
486,Kilcormac,Offaly,53.1764113,-7.7274112,44,2,14,4,760,270,1094,0,Town (Small),48,762,0.06299212598425197
487,Kilcullen,Kildare,53.1302865,-6.745279099999999,228,10,12,76,3584,1384,5294,0,Town (Small),304,3594,0.08458542014468559
488,Kilcummin,Kerry,52.0984108,-9.470070399999999,34,0,0,4,740,36,814,0,Town (Small),38,740,0.051351351351351354
489,Kildalkey,Meath,53.5714499,-6.9060291,166,6,4,4,690,172,1042,0,Town (Small),170,696,0.2442528735632184
490,Kildangan,Kildare,53.1052189,-7.013760100000001,118,0,2,26,500,88,734,0,Town (Small),144,500,0.288
491,Kildare,Kildare,53.15980589999999,-6.9089763,1012,30,22,724,9220,2192,13200,0,Town (Small),1736,9250,0.18767567567567567
492,Kildavin,Carlow,52.683205,-6.6849832,6,0,4,0,172,22,204,0,Town (Small),6,172,0.03488372093023256
493,Kildimo,Limerick,52.6237328,-8.8120969,44,0,0,0,604,44,692,0,Town (Small),44,604,0.0728476821192053
494,Kildorrery,Cork,52.2464986,-8.4273898,46,0,2,2,352,72,474,0,Town (Small),48,352,0.13636363636363635
495,Kildrum,Donegal,54.9791343,-7.419445400000001,66,0,2,2,610,6,686,0,Town (Small),68,610,0.11147540983606558
496,Kildysart,Clare,52.6739738,-9.1075349,14,0,4,0,438,96,552,0,Town (Small),14,438,0.0319634703196347
497,Kilfenora,Clare,52.9899429,-9.218327,16,2,0,0,118,30,166,0,Town (Small),16,120,0.13333333333333333
498,Kilfinnane,Limerick,52.3591426,-8.4682225,30,2,6,2,560,216,816,0,Town (Small),32,562,0.05693950177935943
499,Kilflynn,Kerry,52.3505422,-9.625316399999999,2,0,0,2,178,14,196,0,Town (Small),4,178,0.02247191011235955
500,Kilgarvan,Kerry,51.9031476,-9.4384061,18,2,0,0,268,30,318,0,Town (Small),18,270,0.06666666666666667
501,Kilkee,Clare,52.6828228,-9.6444116,40,0,4,0,552,196,792,0,Town (Small),40,552,0.07246376811594203
502,Kilkelly,Mayo,53.87179219999999,-8.8502415,26,0,2,0,440,42,510,0,Town (Small),26,440,0.05909090909090909
503,Kilkenny,Kilkenny,52.6549027,-7.246402900000001,1564,82,66,252,21044,8804,31812,3,Town (Medium),1816,21126,0.08596042790873805
504,Kilkishen,Clare,52.8071551,-8.747034600000001,94,2,10,2,652,110,870,0,Town (Small),96,654,0.14678899082568808
505,Kill,Kildare,53.24870629999999,-6.590530600000001,808,14,8,24,3654,604,5112,0,Town (Small),832,3668,0.2268266085059978
506,Kill,Waterford,52.1758844,-7.335392100000001,72,2,2,0,276,72,424,0,Town (Small),72,278,0.2589928057553957
507,Killala,Mayo,54.2125146,-9.220999899999999,68,0,4,2,472,74,620,0,Town (Small),70,472,0.1483050847457627
508,Killaloe,Clare,52.808886,-8.4475152,96,0,16,0,1234,504,1850,0,Town (Small),96,1234,0.07779578606158834
509,Killarney,Kerry,52.0598646,-9.504362900000002,750,42,56,96,10416,4364,15724,3,Town (Medium),846,10458,0.08089500860585198
510,Killashee,Longford,53.6812889,-7.879322800000001,16,0,0,2,202,22,242,0,Town (Small),18,202,0.0891089108910891
511,Killavullen,Cork,52.1465049,-8.5166811,34,0,4,0,278,52,368,0,Town (Small),34,278,0.1223021582733813
512,Killeagh,Cork,51.9424888,-7.9920158,156,0,0,16,846,166,1184,0,Town (Small),172,846,0.2033096926713948
513,Killeigh,Offaly,53.2140733,-7.450342699999999,44,0,0,6,166,26,242,0,Town (Small),50,166,0.30120481927710846
514,Killenard,Laois,53.1349458,-7.1478515,92,0,4,40,606,166,908,0,Town (Small),132,606,0.21782178217821782
515,Killenaule,Tipperary,52.5684251,-7.6734719,38,2,6,2,612,106,766,0,Town (Small),40,614,0.06514657980456026
516,Killeshandra,Cavan,54.0138727,-7.5282313,36,0,0,0,152,56,244,0,Town (Small),36,152,0.23684210526315788
517,Killimor,Galway,53.1656231,-8.2910516,30,0,6,2,238,54,330,0,Town (Small),32,238,0.13445378151260504
518,Killinierin,Wexford,52.7300058,-6.2850306,26,0,2,6,288,46,368,0,Town (Small),32,288,0.1111111111111111
519,Killorglin,Kerry,52.10635079999999,-9.7843403,84,8,6,10,1798,582,2488,0,Town (Small),94,1806,0.05204872646733112
520,Killucan-Rathwire,Westmeath,53.5138676,-7.1428989,204,2,12,8,1398,374,1998,0,Town (Small),212,1400,0.15142857142857144
521,Killumney,Cork,51.8637285,-8.6539137,156,0,6,0,1816,90,2068,0,Town (Small),156,1816,0.08590308370044053
522,Killurin,Offaly,53.2173433,-7.5509127,30,0,2,4,166,6,208,0,Town (Small),34,166,0.20481927710843373
523,Killurin,Wexford,53.2173433,-7.5509127,10,0,4,0,276,6,296,0,Town (Small),10,276,0.036231884057971016
524,Killybegs,Donegal,54.6347625,-8.4547084,34,2,8,2,1030,238,1314,0,Town (Small),36,1032,0.03488372093023256
525,Killygordon,Donegal,54.7968309,-7.683535399999999,110,0,0,0,652,116,878,0,Town (Small),110,652,0.1687116564417178
526,Kilmacanogue,Wicklow,53.16901,-6.13946,142,4,18,52,1032,142,1390,0,Town (Small),194,1036,0.18725868725868725
527,Kilmacow,Kilkenny,52.31208050000001,-7.1765298,68,2,4,0,666,42,782,0,Town (Small),68,668,0.10179640718562874
528,Kilmacrennan,Donegal,55.030269,-7.7793541,176,2,4,0,744,100,1026,0,Town (Small),176,746,0.2359249329758713
529,Kilmacthomas,Waterford,52.2054897,-7.426765199999999,38,2,10,0,810,192,1052,0,Town (Small),38,812,0.046798029556650245
530,Kilmaine,Mayo,53.5811547,-9.1227567,30,0,2,2,150,34,218,0,Town (Small),32,150,0.21333333333333335
531,Kilmainhamwood,Meath,53.852351,-6.8048926,56,2,4,2,192,68,324,0,Town (Small),58,194,0.29896907216494845
532,Kilmaley,Clare,52.8188446,-9.1088116,38,2,0,2,354,12,408,0,Town (Small),40,356,0.11235955056179775
533,Kilmallock,Limerick,52.3986185,-8.5715956,36,2,10,2,1210,458,1718,0,Town (Small),38,1212,0.03135313531353135
534,Kilmead,Kildare,53.0347993,-6.9022241,78,0,6,8,308,68,468,0,Town (Small),86,308,0.2792207792207792
535,Kilmeaden,Waterford,52.23333,-7.24281,22,0,0,0,476,6,504,0,Town (Small),22,476,0.046218487394957986
536,Kilmeage,Kildare,53.2510535,-6.8399263,168,2,4,14,1102,46,1336,0,Town (Small),182,1104,0.16485507246376813
537,Kilmessan,Meath,53.55888849999999,-6.6589527,156,2,0,8,836,222,1224,0,Town (Small),164,838,0.1957040572792363
538,Kilmihil,Clare,52.7208888,-9.3198723,6,0,6,4,394,92,502,0,Town (Small),10,394,0.025380710659898477
539,Kilmoganny,Kilkenny,52.46147269999999,-7.3282056,22,0,0,0,226,24,272,0,Town (Small),22,226,0.09734513274336283
540,Kilmore,Wexford,52.2056319,-6.5473792,12,4,0,0,204,24,244,0,Town (Small),12,208,0.057692307692307696
541,Kilmore Quay,Wexford,52.17571940000001,-6.5863919,80,0,8,0,328,44,460,0,Town (Small),80,328,0.24390243902439024
542,Kilmuckridge,Wexford,52.51308849999999,-6.283934599999999,48,6,4,0,604,206,868,0,Town (Small),48,610,0.07868852459016394
543,Kilmurry,Clare,52.7781704,-8.7826372,56,0,2,0,248,30,336,0,Town (Small),56,248,0.22580645161290322
544,Kilnaleck,Cavan,53.8622249,-7.3213784,60,2,4,0,392,140,598,0,Town (Small),60,394,0.15228426395939088
545,Kilpedder,Wicklow,53.11037349999999,-6.1055471,178,6,12,54,1236,56,1542,0,Town (Small),232,1242,0.18679549114331723
546,Kilrush,Clare,52.6406999,-9.4859374,36,2,10,6,1502,696,2252,0,Town (Small),42,1504,0.027925531914893616
547,Kilsheelan,Tipperary,52.3611942,-7.580387699999999,124,0,2,0,876,102,1104,0,Town (Small),124,876,0.1415525114155251
548,Kilteel,Kildare,53.2359545,-6.521514199999999,42,4,0,8,270,4,328,0,Town (Small),50,274,0.18248175182481752
549,Kilteely,Limerick,52.55401999999999,-8.391494999999999,18,0,0,0,186,10,214,0,Town (Small),18,186,0.0967741935483871
550,Kiltimagh,Mayo,53.8494839,-8.9994739,30,2,10,12,1062,280,1396,0,Town (Small),42,1064,0.039473684210526314
551,Kilworth,Cork,52.1760533,-8.247312299999999,142,4,10,0,1070,308,1534,0,Town (Small),142,1074,0.13221601489757914
552,Kingscourt,Cavan,53.9068739,-6.8052229,140,0,20,6,2924,636,3726,0,Town (Small),146,2924,0.04993160054719562
553,Kinlough,Leitrim,54.4487146,-8.2858213,138,0,18,2,1198,172,1528,0,Town (Small),140,1198,0.11686143572621036
554,Kinnegad,Westmeath,53.4568103,-7.1049959,884,10,8,18,2380,656,3956,0,Town (Small),902,2390,0.37740585774058577
555,Kinnitty,Offaly,53.097806,-7.7189969,38,0,0,0,238,58,334,0,Town (Small),38,238,0.15966386554621848
556,Kinsale,Cork,51.7058853,-8.5222327,306,16,20,20,4692,1788,6842,0,Town (Small),326,4708,0.06924384027187766
557,Kinsaley,Dublin,53.4245123,-6.1763644,112,0,2,92,742,86,1034,0,Town (Small),204,742,0.2749326145552561
558,Kinsealy-Drinan,Dublin,53.4245123,-6.1763644,1758,44,34,142,6546,2020,10544,0,Town (Small),1900,6590,0.2883156297420334
559,Kinvarra,Galway,53.1389085,-8.9362964,56,0,6,4,600,272,938,0,Town (Small),60,600,0.1
560,Knightstown,Kerry,51.9253777,-10.2918805,32,6,0,0,164,28,230,0,Town (Small),32,170,0.18823529411764706
561,Knock,Mayo,53.7900638,-8.921465999999999,82,2,6,2,746,108,946,0,Town (Small),84,748,0.11229946524064172
562,Knockananna,Wicklow,52.87287190000001,-6.4970477,34,0,8,2,184,14,242,0,Town (Small),36,184,0.1956521739130435
563,Knockbridge,Louth,53.9718223,-6.486281099999999,118,4,2,4,728,164,1020,0,Town (Small),122,732,0.16666666666666666
564,Knockcroghery,Roscommon,53.5743895,-8.0922325,56,0,2,4,426,44,532,0,Town (Small),60,426,0.14084507042253522
565,Knocklong,Limerick,52.4373844,-8.4117892,26,0,4,0,200,14,244,0,Town (Small),26,200,0.13
566,Knocknagree,Cork,51.8897908,-8.4983892,20,2,0,0,188,38,248,0,Town (Small),20,190,0.10526315789473684
567,Knockraha,Cork,51.9579423,-8.3400979,56,2,0,4,536,180,778,0,Town (Small),60,538,0.11152416356877323
568,Knocktopher,Kilkenny,52.4856956,-7.217107599999999,22,0,2,0,180,16,220,0,Town (Small),22,180,0.12222222222222222
569,Lackaghbeg,Galway,53.3659038,-8.8813396,116,0,8,2,584,156,866,0,Town (Small),118,584,0.20205479452054795
570,Ladysbridge,Cork,51.89760829999999,-8.0433337,228,2,0,8,872,40,1150,0,Town (Small),236,874,0.2700228832951945
571,Laghy,Donegal,54.61819999999999,-8.0876,2,0,4,0,154,24,184,0,Town (Small),2,154,0.012987012987012988
572,Lahardane,Mayo,54.0295472,-9.3220186,36,0,0,0,222,18,276,0,Town (Small),36,222,0.16216216216216217
573,Lanesborough-Ballyleague,Roscommon,53.6744226,-7.9929157,108,2,2,16,1564,304,1996,0,Town (Small),124,1566,0.07918263090676884
574,Laragh,Wicklow,53.0089293,-6.3004389,52,2,2,2,386,92,536,0,Town (Small),54,388,0.13917525773195877
575,Laytown-Bettystown-Mornington-Donacarney,Meath,53.69861100000001,-6.244721999999999,3678,46,40,836,13256,2456,20312,3,Town (Medium),4514,13302,0.339347466546384
576,Leap,Cork,51.5811998,-9.1408671,4,2,2,0,124,4,136,0,Town (Small),4,126,0.031746031746031744
577,Legan,Longford,53.6212481,-7.6308386,48,0,4,0,290,58,400,0,Town (Small),48,290,0.16551724137931034
578,Lehinch,Clare,52.9334632,-9.3440769,36,2,0,2,794,108,942,0,Town (Small),38,796,0.04773869346733668
579,Leighlinbridge,Carlow,52.73605190000001,-6.9759183,126,0,0,8,992,122,1248,0,Town (Small),134,992,0.1350806451612903
580,Leitrim,Leitrim,53.99019,-8.06501,80,0,4,6,696,126,912,0,Town (Small),86,696,0.1235632183908046
581,Leixlip,Kildare,53.36384280000001,-6.4900033,2236,94,32,1842,11794,4658,20656,3,Town (Medium),4078,11888,0.3430349932705249
582,Lemybrien,Waterford,52.1683402,-7.519583700000001,20,0,6,0,272,6,304,0,Town (Small),20,272,0.07352941176470588
583,Letterkenny,Donegal,54.9558392,-7.7342787,2608,14,68,30,19522,3916,26158,3,Town (Medium),2638,19536,0.13503276003276005
584,Lifford,Donegal,54.8328751,-7.485638899999999,192,0,8,2,1268,182,1652,0,Town (Small),194,1268,0.1529968454258675
585,Limerick city and suburbs,Limerick,52.663839,-8.626729899999999,9668,368,194,318,69568,30006,110122,2,Town (Large),9986,69936,0.14278769160375201
586,Liscannor,Clare,52.9383667,-9.3922452,6,0,0,0,100,6,112,0,Town (Small),6,100,0.06
587,Liscarroll,Cork,52.2600728,-8.8041711,14,0,0,0,190,40,244,0,Town (Small),14,190,0.07368421052631578
588,Lisdoonvarna,Clare,53.0301669,-9.2897106,10,2,0,0,294,154,460,0,Town (Small),10,296,0.033783783783783786
589,Lismore,Waterford,52.13581840000001,-7.9376803,54,4,20,0,1030,510,1618,0,Town (Small),54,1034,0.05222437137330754
590,Lisronagh,Tipperary,52.417443,-7.7028889,26,2,2,0,230,16,276,0,Town (Small),26,232,0.11206896551724138
591,Lissycasey,Clare,52.7446724,-9.158153,86,0,2,0,512,4,604,0,Town (Small),86,512,0.16796875
592,Listowel,Kerry,52.4460488,-9.4853655,224,4,18,12,3958,884,5100,0,Town (Small),236,3962,0.05956587582029278
593,Littleton,Tipperary,52.6369829,-7.735418999999998,60,0,2,4,286,82,434,0,Town (Small),64,286,0.22377622377622378
594,Lixnaw,Kerry,52.4064615,-9.6181275,128,2,4,0,794,70,998,0,Town (Small),128,796,0.16080402010050251
595,Loch An Iúir,Donegal,54.9981527,-8.291505299999999,72,0,0,0,310,26,408,0,Town (Small),72,310,0.23225806451612904
596,Loch Gowna,Cavan,53.87370490000001,-7.5336731,8,0,0,0,144,36,188,0,Town (Small),8,144,0.05555555555555555
597,Longford,Longford,53.7276296,-7.7932573,760,12,36,212,6942,3074,11036,0,Town (Small),972,6954,0.13977566867989646
598,Longwood,Meath,53.4550101,-6.9247866,136,2,14,20,1482,706,2360,0,Town (Small),156,1484,0.10512129380053908
599,Loughglinn,Roscommon,53.8225476,-8.561582999999999,10,0,4,2,154,34,204,0,Town (Small),12,154,0.07792207792207792
600,Loughrea,Galway,53.1989136,-8.5660931,418,8,20,10,5490,1404,7350,0,Town (Small),428,5498,0.07784648963259368
601,Loughshinny,Dublin,53.54922800000001,-6.0829049,108,6,4,62,494,122,796,0,Town (Small),170,500,0.34
602,Louisburgh,Mayo,53.7631376,-9.8090849,12,0,2,0,300,64,378,0,Town (Small),12,300,0.04
603,Louth,Louth,53.9507955,-6.5406821,142,2,2,2,610,102,860,0,Town (Small),144,612,0.23529411764705882
604,Lusk,Dublin,53.52632639999999,-6.1658841,1536,48,22,634,7048,2784,12072,0,Town (Small),2170,7096,0.30580608793686587
605,Lyre,Cork,52.0817595,-8.8580581,22,0,0,0,148,50,220,0,Town (Small),22,148,0.14864864864864866
606,Macroom,Cork,51.9048039,-8.9588478,160,6,24,8,3924,1064,5186,0,Town (Small),168,3930,0.042748091603053436
607,Maigh Cuilinn,Galway,53.3387481,-9.1814776,284,6,8,10,2096,442,2846,0,Town (Small),294,2102,0.13986679352997144
608,Malahide,Dublin,53.4509236,-6.1501378,2010,46,44,3284,12698,4340,22422,3,Town (Medium),5294,12744,0.41541117388575016
609,Malin,Donegal,55.2949279,-7.263082499999999,2,0,0,0,64,8,74,0,Town (Small),2,64,0.03125
610,Mallow,Cork,52.13897619999999,-8.6539164,582,22,62,428,12144,2932,16170,3,Town (Medium),1010,12166,0.0830182475752096
611,Manor Kilbride,Wicklow,53.1986734,-6.4669351,20,0,4,2,184,6,216,0,Town (Small),22,184,0.11956521739130435
612,Manorcunningham,Donegal,54.9552585,-7.6233678,178,0,6,2,766,24,976,0,Town (Small),180,766,0.2349869451697128
613,Manorhamilton,Leitrim,54.3048735,-8.1766956,64,2,12,4,1306,522,1910,0,Town (Small),68,1308,0.05198776758409786
614,Maynooth,Kildare,53.3812896,-6.5918499,1766,84,34,2166,12062,7018,23130,3,Town (Medium),3932,12146,0.32372797628849004
615,Midleton,Cork,51.9143321,-8.1726276,976,32,24,718,13762,3020,18532,3,Town (Medium),1694,13794,0.12280701754385964
616,Milford,Cork,51.8721994,-8.4998655,20,0,0,0,254,20,294,0,Town (Small),20,254,0.07874015748031496
617,Milford,Donegal,55.0883927,-7.698962099999999,74,4,8,0,932,160,1178,0,Town (Small),74,936,0.07905982905982906
618,Millstreet,Cork,52.06013180000001,-9.0647121,76,0,20,18,1642,314,2070,0,Town (Small),94,1642,0.057247259439707675
619,Milltown,Galway,53.6137016,-8.898962000000001,28,0,4,2,242,8,284,0,Town (Small),30,242,0.12396694214876033
620,Milltown,Kerry,52.1451912,-9.7175069,70,2,4,4,1042,296,1418,0,Town (Small),74,1044,0.07088122605363985
621,Milltown,Kildare,53.2051083,-6.861192699999999,28,4,14,12,366,26,450,0,Town (Small),40,370,0.10810810810810811
622,Miltown Malbay,Clare,52.8562013,-9.4007763,36,0,2,4,852,116,1010,0,Town (Small),40,852,0.046948356807511735
623,Mitchelstown,Cork,52.2662127,-8.2698863,110,4,4,2,3010,1094,4224,0,Town (Small),112,3014,0.0371599203715992
624,Moate,Westmeath,53.3949987,-7.7186188,140,6,6,22,2698,558,3430,0,Town (Small),162,2704,0.059911242603550297
625,Model Village or Dripsey,Cork,51.9143772,-8.7420906,56,0,4,0,306,10,376,0,Town (Small),56,306,0.1830065359477124
626,Mogeely,Cork,51.8861108,-8.4989926,64,4,2,4,554,24,652,0,Town (Small),68,558,0.12186379928315412
627,Mohill,Leitrim,53.9218288,-7.865310099999999,26,0,6,14,742,222,1010,0,Town (Small),40,742,0.05390835579514825
628,Monaghan,Monaghan,54.2492434,-6.9683082,466,10,22,22,6608,1998,9126,0,Town (Small),488,6618,0.07373828951344817
629,Monamolin,Wexford,52.556856,-6.3496134,58,0,0,0,252,18,328,0,Town (Small),58,252,0.23015873015873015
630,Monard,Tipperary,52.5107814,-8.2232875,28,0,6,8,260,50,352,0,Town (Small),36,260,0.13846153846153847
631,Monasterevin,Kildare,53.1400651,-7.060377,530,10,26,248,5018,966,6798,0,Town (Small),778,5028,0.15473349244232298
632,Moneenroe,Kilkenny,52.83215449999999,-7.171786499999999,60,0,6,2,744,62,874,0,Town (Small),62,744,0.08333333333333333
633,Moneygall,Offaly,52.87973760000001,-7.9578079,48,0,2,2,360,34,446,0,Town (Small),50,360,0.1388888888888889
634,Monivea,Galway,53.37426199999999,-8.702721,26,0,4,8,508,62,608,0,Town (Small),34,508,0.06692913385826772
635,Mooncoin,Kilkenny,52.2951348,-7.2565554,72,0,6,6,976,214,1274,0,Town (Small),78,976,0.07991803278688525
636,Moroe,Limerick,52.649444,-8.39949,192,4,8,0,1510,232,1946,0,Town (Small),192,1514,0.12681638044914134
637,Mountbellew,Galway,53.47188,-8.5049,32,0,2,2,788,126,950,0,Town (Small),34,788,0.04314720812182741
638,Mountcharles,Donegal,54.6474421,-8.1947189,98,2,4,2,660,82,848,0,Town (Small),100,662,0.1510574018126888
639,Mountcollins,Limerick,52.3220585,-9.2386125,22,2,4,0,220,4,252,0,Town (Small),22,222,0.0990990990990991
640,Mountmellick,Laois,53.1181481,-7.3267379,278,2,14,140,4194,1190,5818,0,Town (Small),418,4196,0.0996186844613918
641,Mountrath,Laois,53.0025597,-7.4751396,160,4,10,26,1590,456,2246,0,Town (Small),186,1594,0.11668757841907151
642,Mountshannon,Clare,52.9337525,-8.4330044,28,0,2,0,220,28,278,0,Town (Small),28,220,0.12727272727272726
643,Moville,Donegal,55.1890182,-7.040053299999999,106,2,6,2,1038,280,1434,0,Town (Small),108,1040,0.10384615384615385
644,Moylough,Galway,53.48770529999999,-8.565876,54,0,0,2,648,50,754,0,Town (Small),56,648,0.08641975308641975
645,Mucklagh,Offaly,53.250532,-7.550175399999999,102,2,6,26,930,116,1182,0,Town (Small),128,932,0.13733905579399142
646,Muff,Donegal,55.0680564,-7.2689498,220,4,10,0,1458,108,1800,0,Town (Small),220,1462,0.15047879616963064
647,Muinebeag (Bagenalstown),Carlow,52.7007292,-6.957055599999999,102,4,14,60,2138,1054,3372,0,Town (Small),162,2142,0.07563025210084033
648,Mullagh,Cavan,53.8115174,-6.945981799999999,322,2,10,2,1490,304,2130,0,Town (Small),324,1492,0.21715817694369974
649,Mullaghmore,Sligo,54.4655463,-8.4494545,10,0,4,2,114,8,138,0,Town (Small),12,114,0.10526315789473684
650,Mullinahone,Tipperary,52.512032,-7.505708599999999,66,2,0,0,418,98,584,0,Town (Small),66,420,0.15714285714285714
651,Mullinavat,Kilkenny,52.3679303,-7.1711881,18,0,0,2,164,20,204,0,Town (Small),20,164,0.12195121951219512
652,Mullingar,Westmeath,53.5259334,-7.3381378,1004,64,90,544,19164,5576,26442,3,Town (Medium),1548,19228,0.08050759309340545
653,Mulranny,Mayo,53.9061783,-9.781377299999999,52,0,0,0,206,52,310,0,Town (Small),52,206,0.2524271844660194
654,Multyfarnham,Westmeath,53.6252723,-7.3893159,42,0,4,4,360,96,506,0,Town (Small),46,360,0.12777777777777777
655,Mungret,Limerick,52.6356745,-8.693501999999999,42,0,0,2,422,38,504,0,Town (Small),44,422,0.10426540284360189
656,Murntown,Wexford,52.28724,-6.5222437,28,2,0,0,376,32,438,0,Town (Small),28,378,0.07407407407407407
657,Myrtleville,Cork,51.7829961,-8.3003542,70,0,10,6,952,64,1102,0,Town (Small),76,952,0.07983193277310924
658,Myshall,Carlow,52.6858791,-6.7804051,52,0,0,2,260,26,340,0,Town (Small),54,260,0.2076923076923077
659,Mín Lárach,Donegal,55.1451784,-8.1850861,64,0,2,4,356,20,446,0,Town (Small),68,356,0.19101123595505617
660,Na Dúnaibh,Donegal,55.1948628,-7.8369654,122,0,6,0,502,38,668,0,Town (Small),122,502,0.24302788844621515
661,Na Forbacha,Galway,53.24918,-9.20495,80,0,0,4,812,124,1020,0,Town (Small),84,812,0.10344827586206896
662,Naas,Kildare,53.2205654,-6.6593079,2620,128,76,1500,23488,6738,34550,3,Town (Medium),4120,23616,0.1744579945799458
663,Narraghmore,Kildare,53.04868010000001,-6.8294142,100,4,0,6,440,18,568,0,Town (Small),106,444,0.23873873873873874
664,Naul,Dublin,53.5850362,-6.288999899999999,104,0,6,26,712,128,976,0,Town (Small),130,712,0.18258426966292135
665,Navan,Meath,53.647092,-6.6966605,4880,88,96,140,28866,9904,43974,3,Town (Medium),5020,28954,0.17337846238861643
666,Nenagh,Tipperary,52.8642968,-8.1975561,450,14,24,22,8688,2992,12190,0,Town (Small),472,8702,0.05424040450471156
667,New Ross,Wexford,52.3958337,-6.945456699999999,668,14,34,12,6710,1810,9248,0,Town (Small),680,6724,0.10113027959547888
668,Newbawn,Wexford,52.3428304,-6.7912642,24,0,0,0,142,18,184,0,Town (Small),24,142,0.16901408450704225
669,Newbliss,Monaghan,54.1576466,-7.1368133,44,0,0,0,326,50,420,0,Town (Small),44,326,0.13496932515337423
670,Newbridge,Kildare,53.17507579999999,-6.8047467,1836,94,66,1736,20074,7288,31094,3,Town (Medium),3572,20168,0.1771122570408568
671,Newcastle,Dublin,53.2998135,-6.5010237,780,20,10,126,4108,1034,6078,0,Town (Small),906,4128,0.2194767441860465
672,Newcastle,Tipperary,52.2725965,-7.8112834,64,0,2,0,264,94,424,0,Town (Small),64,264,0.24242424242424243
673,Newcastle,Wicklow,53.07335519999999,-6.057185,160,8,4,62,938,94,1266,0,Town (Small),222,946,0.2346723044397463
674,Newcastle West,Limerick,52.4492389,-9.0499054,444,4,14,12,6540,1564,8578,0,Town (Small),456,6544,0.06968215158924206
675,Newmarket,Cork,52.2140232,-9.0030815,48,0,8,6,958,128,1148,0,Town (Small),54,958,0.05636743215031315
676,Newmarket-On-Fergus,Clare,52.7605328,-8.895750099999999,208,8,4,2,1848,286,2356,0,Town (Small),210,1856,0.11314655172413793
677,Newport,Mayo,53.8852758,-9.5463685,68,0,8,2,652,134,864,0,Town (Small),70,652,0.10736196319018405
678,Newport,Tipperary,52.71089629999999,-8.406208399999999,112,2,6,0,2352,538,3010,0,Town (Small),112,2354,0.0475785896346644
679,Newtown,Cork,51.8282409,-8.3803862,30,0,6,0,444,70,550,0,Town (Small),30,444,0.06756756756756757
680,Newtown,Laois,52.8630266,-7.1082572,36,0,2,0,274,18,330,0,Town (Small),36,274,0.13138686131386862
681,Newtown,Tipperary,52.8778127,-8.292807,24,0,6,0,484,68,582,0,Town (Small),24,484,0.049586776859504134
682,Newtowncunningham,Donegal,54.99881749999999,-7.5127836,246,2,4,2,1014,176,1444,0,Town (Small),248,1016,0.2440944881889764
683,Newtownforbes,Longford,53.7654838,-7.835621,112,2,2,14,710,114,954,0,Town (Small),126,712,0.17696629213483145
684,Newtownmountkennedy,Wicklow,53.0927815,-6.112023,670,14,26,68,3318,576,4672,0,Town (Small),738,3332,0.22148859543817526
685,Newtownsandes,Kerry,52.50166,-9.3705609,40,0,0,0,308,42,390,0,Town (Small),40,308,0.12987012987012986
686,Nobber,Meath,53.8217066,-6.747939799999999,28,0,0,0,280,152,460,0,Town (Small),28,280,0.1
687,Nurney,Kildare,53.0966332,-6.9482121,84,0,6,16,440,114,660,0,Town (Small),100,440,0.22727272727272727
688,O'Briensbridge-Montpelier,Clare,52.75060389999999,-8.496743,56,0,10,0,430,12,508,0,Town (Small),56,430,0.13023255813953488
689,Oilgate,Wexford,52.42101,-6.52994,40,0,4,0,352,46,442,0,Town (Small),40,352,0.11363636363636363
690,Oldcastle,Meath,53.7700178,-7.162411799999999,44,2,16,4,1108,604,1778,0,Town (Small),48,1110,0.043243243243243246
691,Oldtown,Dublin,53.522678,-6.315430699999999,92,2,6,2,530,54,686,0,Town (Small),94,532,0.17669172932330826
692,Omeath,Louth,54.0882604,-6.2593365,124,2,6,0,558,92,782,0,Town (Small),124,560,0.22142857142857142
693,Oola,Limerick,52.5296598,-8.2596358,36,0,2,4,258,28,328,0,Town (Small),40,258,0.15503875968992248
694,Oram,Monaghan,54.1508756,-6.7016152,16,0,4,0,164,24,208,0,Town (Small),16,164,0.0975609756097561
695,Oranmore,Galway,53.2647506,-8.9297335,436,18,10,120,5970,1400,7954,0,Town (Small),556,5988,0.09285237140948564
696,Oughterard,Galway,53.42854810000001,-9.3189472,134,6,8,4,1696,336,2184,0,Town (Small),138,1702,0.08108108108108109
697,Oulart,Wexford,52.5039145,-6.390861699999999,22,0,2,4,214,24,266,0,Town (Small),26,214,0.12149532710280374
698,Palatine,Carlow,52.8649974,-6.8610348,16,0,2,4,348,6,376,0,Town (Small),20,348,0.05747126436781609
699,Pallasgreen,Limerick,52.54873,-8.355184999999999,52,0,2,0,202,20,276,0,Town (Small),52,202,0.25742574257425743
700,Pallaskenry,Limerick,52.6447411,-8.8674281,12,0,4,0,584,168,768,0,Town (Small),12,584,0.02054794520547945
701,Parteen,Clare,52.696836,-8.6149881,32,2,4,4,776,160,978,0,Town (Small),36,778,0.04627249357326478
702,Passage East,Waterford,52.2396938,-6.974394999999999,40,4,2,0,712,74,832,0,Town (Small),40,716,0.055865921787709494
703,Passage West-Monkstown,Cork,51.8485442,-8.3325695,654,24,28,6,6240,678,7630,0,Town (Small),660,6264,0.1053639846743295
704,Patrickswell,Limerick,52.5980577,-8.707284399999999,114,4,4,0,728,134,984,0,Town (Small),114,732,0.1557377049180328
705,Paulstown,Kilkenny,52.6793223,-7.021358999999999,154,2,2,0,996,132,1286,0,Town (Small),154,998,0.15430861723446893
706,Pettigo,Donegal,54.54943,-7.832033900000001,20,0,2,0,96,16,134,0,Town (Small),20,96,0.20833333333333334
707,Piercetown,Wexford,52.28785999999999,-6.48747,16,0,2,0,296,36,350,0,Town (Small),16,296,0.05405405405405406
708,Piltown,Kilkenny,52.3511631,-7.331338099999999,184,2,8,2,1212,208,1616,0,Town (Small),186,1214,0.15321252059308071
709,Pollagh,Offaly,53.2768407,-7.709173000000001,54,0,2,0,178,18,252,0,Town (Small),54,178,0.30337078651685395
710,Portarlington,Laois,53.1616096,-7.1895142,1172,18,36,650,7934,1676,11486,0,Town (Small),1822,7952,0.22912474849094566
711,Portlaoise,Laois,53.0328123,-7.298793300000001,2156,64,84,792,20472,4610,28178,3,Town (Medium),2948,20536,0.14355278535255162
712,Portlaw,Waterford,52.28926569999999,-7.3147439,380,8,4,2,1696,332,2422,0,Town (Small),382,1704,0.22417840375586853
713,Portmagee,Kerry,51.8854295,-10.36194,30,0,4,0,68,30,132,0,Town (Small),30,68,0.4411764705882353
714,Portmarnock,Dublin,53.418712,-6.154901499999999,724,42,16,2170,6590,2954,12496,0,Town (Small),2894,6632,0.43636911942098916
715,Portrane,Dublin,53.49319999999999,-6.11462,166,10,8,136,1006,118,1444,0,Town (Small),302,1016,0.297244094488189
716,Portroe,Tipperary,52.8847,-8.344875,62,0,6,0,454,44,566,0,Town (Small),62,454,0.13656387665198239
717,Portumna,Galway,53.0927811,-8.218540599999999,32,0,6,12,1286,448,1784,0,Town (Small),44,1286,0.03421461897356143
718,Prosperous,Kildare,53.2881253,-6.7550083,310,6,8,34,2222,552,3132,0,Town (Small),344,2228,0.15439856373429084
719,Puckaun,Tipperary,52.931884,-8.2385501,24,0,0,0,222,28,274,0,Town (Small),24,222,0.10810810810810811
720,Quigleys Point,Donegal,55.1248808,-7.194928300000001,52,0,0,0,192,12,256,0,Town (Small),52,192,0.2708333333333333
721,Quilty,Clare,52.81725669999999,-9.4559219,6,0,0,0,176,8,190,0,Town (Small),6,176,0.03409090909090909
722,Quin,Clare,52.8175778,-8.8637803,104,4,6,2,1004,190,1310,0,Town (Small),106,1008,0.10515873015873016
723,Raharney,Westmeath,53.5241052,-7.0960895,30,2,0,4,140,12,188,0,Town (Small),34,142,0.23943661971830985
724,Ramelton,Donegal,55.03590000000001,-7.64809,204,0,6,0,1006,166,1382,0,Town (Small),204,1006,0.20278330019880716
725,Rampark,Louth,53.97515,-6.48617,78,0,2,4,444,80,608,0,Town (Small),82,444,0.18468468468468469
726,Rann Na Feirste,Donegal,55.034738,-8.3063621,74,0,2,0,324,30,430,0,Town (Small),74,324,0.22839506172839505
727,Raphoe,Donegal,54.8738705,-7.5994379,50,0,10,0,784,246,1090,0,Town (Small),50,784,0.06377551020408163
728,Rathangan,Kildare,53.2210179,-6.9945422,98,10,8,94,3268,784,4262,0,Town (Small),192,3278,0.05857230018303844
729,Rathard-Aherla,Cork,51.8536728,-8.732601899999999,106,0,6,0,736,18,866,0,Town (Small),106,736,0.14402173913043478
730,Rathcoffey,Kildare,53.3342027,-6.678636200000001,56,0,2,12,314,64,448,0,Town (Small),68,314,0.21656050955414013
731,Rathcoole,Cork,52.0942583,-8.974065099999999,42,0,2,2,218,36,300,0,Town (Small),44,218,0.2018348623853211
732,Rathcoole,Dublin,53.2817307,-6.466167,422,32,16,148,4636,2108,7362,0,Town (Small),570,4668,0.12210796915167095
733,Rathcormac,Cork,52.07613,-8.28176,388,6,10,4,1890,518,2816,0,Town (Small),392,1896,0.20675105485232068
734,Rathdowney,Laois,52.8555198,-7.584797300000001,54,0,4,24,1164,408,1654,0,Town (Small),78,1164,0.06701030927835051
735,Rathdrum,Wicklow,52.93231230000001,-6.231101199999999,80,6,8,110,1974,614,2792,0,Town (Small),190,1980,0.09595959595959595
736,Rathkeale,Limerick,52.5225255,-8.9403655,32,0,10,0,590,312,944,0,Town (Small),32,590,0.05423728813559322
737,Rathmolyon,Meath,53.488177,-6.8036692,84,0,4,12,502,24,626,0,Town (Small),96,502,0.19123505976095617
738,Rathmore,Kerry,52.0842484,-9.2184337,126,2,6,12,868,40,1054,0,Town (Small),138,870,0.15862068965517243
739,Rathmullan,Donegal,55.0970707,-7.5363061,50,0,4,2,386,82,524,0,Town (Small),52,386,0.13471502590673576
740,Rathnew,Wicklow,52.9946004,-6.082812,276,12,22,44,3490,818,4662,0,Town (Small),320,3502,0.09137635636778983
741,Rathowen,Westmeath,53.656076,-7.5203959,32,0,2,0,132,36,202,0,Town (Small),32,132,0.24242424242424243
742,Rathtoe,Carlow,52.835854,-6.932474399999999,42,2,0,4,352,50,450,0,Town (Small),46,354,0.12994350282485875
743,Rathvilly,Carlow,52.87983449999999,-6.6960481,138,2,8,0,1012,146,1306,0,Town (Small),138,1014,0.13609467455621302
744,Ratoath,Meath,53.5062898,-6.465680099999999,1544,32,18,116,9354,3642,14706,0,Town (Small),1660,9386,0.176859151928404
745,Rear Cross,Tipperary,52.6863722,-8.2370086,20,0,6,0,114,36,176,0,Town (Small),20,114,0.17543859649122806
746,Redcross,Wicklow,52.88974400000001,-6.1452741,60,0,0,8,218,38,324,0,Town (Small),68,218,0.3119266055045872
747,Rhode,Offaly,53.3499888,-7.198962900000001,156,0,4,0,712,82,954,0,Town (Small),156,712,0.21910112359550563
748,Ringaskiddy-Loughbeg,Cork,51.83042829999999,-8.3219487,62,0,8,2,648,86,806,0,Town (Small),64,648,0.09876543209876543
749,Rivermeade,Dublin,53.45355,-6.28999,132,0,2,0,354,116,604,0,Town (Small),132,354,0.3728813559322034
750,Riverstick,Cork,51.773023,-8.4960524,238,2,0,2,888,34,1164,0,Town (Small),240,890,0.2696629213483146
751,Riverstown,Sligo,54.1304398,-8.3952507,38,0,4,2,376,58,478,0,Town (Small),40,376,0.10638297872340426
752,Robertstown,Kildare,53.269268,-6.815316399999999,86,2,4,6,792,72,962,0,Town (Small),92,794,0.11586901763224182
753,Robinstown,Meath,53.5946777,-6.7280973,74,0,4,2,396,108,584,0,Town (Small),76,396,0.1919191919191919
754,Rochfortbridge,Westmeath,53.4146417,-7.2996835,136,0,24,6,1194,468,1828,0,Town (Small),142,1194,0.11892797319932999
755,Rockcorry,Monaghan,54.1178982,-7.0148381,46,2,4,0,264,46,362,0,Town (Small),46,266,0.17293233082706766
756,Roosky,Leitrim,53.827075,-7.9168239,94,0,4,12,654,110,874,0,Town (Small),106,654,0.1620795107033639
757,Roscommon,Roscommon,53.63401649999999,-8.181945899999999,254,10,32,70,5814,1560,7740,0,Town (Small),324,5824,0.05563186813186813
758,Roscrea,Tipperary,52.9551789,-7.798469600000001,388,8,52,22,4808,1314,6592,0,Town (Small),410,4816,0.08513289036544851
759,Rosegreen,Tipperary,52.469442,-7.8327776,22,0,0,0,216,34,272,0,Town (Small),22,216,0.10185185185185185
760,Rosscahill,Galway,53.38712,-9.246229999999999,38,0,0,0,392,30,460,0,Town (Small),38,392,0.09693877551020408
761,Rosscarbery,Cork,51.57767,-9.038,14,2,4,0,566,108,694,0,Town (Small),14,568,0.02464788732394366
762,Rosses Point,Sligo,54.3047546,-8.5640206,68,2,0,8,764,118,960,0,Town (Small),76,766,0.09921671018276762
763,Rosslare,Wexford,52.2720275,-6.3892254,218,2,8,32,1470,210,1940,0,Town (Small),250,1472,0.16983695652173914
764,Rosslare Harbour,Wexford,52.2513061,-6.3414908,342,2,24,8,1712,258,2346,0,Town (Small),350,1714,0.20420070011668612
765,Roundstone,Galway,53.39642079999999,-9.919018399999999,32,0,2,0,124,30,188,0,Town (Small),32,124,0.25806451612903225
766,Roundwood,Wicklow,53.0657875,-6.2241877,204,4,4,8,778,224,1222,0,Town (Small),212,782,0.2710997442455243
767,Rush,Dublin,53.5256684,-6.0911586,1790,56,62,1052,8350,2900,14210,3,Town (Medium),2842,8406,0.33809183916250296
768,Saggart,Dublin,53.284435,-6.440534599999999,346,30,2,418,2792,834,4422,0,Town (Small),764,2822,0.27072997873848337
769,Saleen,Cork,51.8637224,-8.161825799999999,86,2,2,10,658,72,830,0,Town (Small),96,660,0.14545454545454545
770,Sallins,Kildare,53.251067,-6.6652312,1018,28,18,1018,5270,1454,8806,0,Town (Small),2036,5298,0.38429596073990185
771,Scarriff-Tuamgraney,Clare,52.8985172,-8.541013,18,0,6,0,470,172,666,0,Town (Small),18,470,0.03829787234042553
772,Schull,Cork,51.526867,-9.5479801,14,4,6,0,432,180,636,0,Town (Small),14,436,0.03211009174311927
773,Scotshouse,Monaghan,54.1226216,-7.2471111,74,0,0,0,316,42,432,0,Town (Small),74,316,0.23417721518987342
774,Scotstown,Monaghan,54.2778889,-7.066951400000001,68,2,0,6,490,32,598,0,Town (Small),74,492,0.15040650406504066
775,Shanagarry,Cork,51.8527122,-8.0299249,90,2,8,12,700,78,890,0,Town (Small),102,702,0.1452991452991453
776,Shanagolden,Limerick,52.5746155,-9.1004049,12,0,0,0,130,8,150,0,Town (Small),12,130,0.09230769230769231
777,Shanbally,Cork,51.8334141,-8.3570879,32,2,0,0,402,68,504,0,Town (Small),32,404,0.07920792079207921
778,Shanballymore,Cork,52.2187977,-8.4759914,30,0,2,4,166,38,240,0,Town (Small),34,166,0.20481927710843373
779,Shannon,Clare,52.71178219999999,-8.8783365,696,34,38,12,8318,3710,12808,0,Town (Small),708,8352,0.08477011494252873
780,Shannonbridge,Offaly,53.279632,-8.044721299999999,36,0,0,0,98,6,140,0,Town (Small),36,98,0.3673469387755102
781,Shercock,Cavan,53.9950108,-6.8979854,70,0,2,2,500,212,786,0,Town (Small),72,500,0.144
782,Shillelagh,Wicklow,52.7545156,-6.533460499999999,36,0,0,0,376,52,464,0,Town (Small),36,376,0.09574468085106383
783,Shinrone,Offaly,52.9844035,-7.9245622,82,0,6,4,498,108,698,0,Town (Small),86,498,0.17269076305220885
784,Shrule,Mayo,53.5202745,-9.0883693,50,0,0,0,364,32,446,0,Town (Small),50,364,0.13736263736263737
785,Silvermines,Tipperary,52.79436099999999,-8.2366272,36,2,2,0,280,26,346,0,Town (Small),36,282,0.1276595744680851
786,Sixmilebridge,Clare,52.7420054,-8.772400500000002,446,10,18,46,2966,478,3964,0,Town (Small),492,2976,0.16532258064516128
787,Skerries,Dublin,53.5805519,-6.1078779,606,34,26,2244,6622,3734,13266,0,Town (Small),2850,6656,0.42818509615384615
788,Skibbereen,Cork,51.55592439999999,-9.262130299999999,68,2,12,2,2382,880,3346,0,Town (Small),70,2384,0.02936241610738255
789,Slane,Meath,53.7086474,-6.543651199999999,340,2,6,2,1192,276,1818,0,Town (Small),342,1194,0.2864321608040201
790,Slieverue,Kilkenny,52.2828142,-7.0689659,50,2,2,2,424,66,546,0,Town (Small),52,426,0.12206572769953052
791,Sligo,Sligo,54.27661029999999,-8.4760888,978,60,50,102,14140,7430,22760,3,Town (Medium),1080,14200,0.07605633802816901
792,Smithborough,Monaghan,54.2213027,-7.0981545,80,0,2,0,550,52,684,0,Town (Small),80,550,0.14545454545454545
793,Sneem,Kerry,51.8373942,-9.8983245,46,0,0,0,184,146,376,0,Town (Small),46,184,0.25
794,Spa,Kerry,52.27538999999999,-9.788499999999999,6,0,0,6,380,40,432,0,Town (Small),12,380,0.031578947368421054
795,Spanish Point,Clare,52.8466428,-9.4397015,8,0,0,10,220,16,254,0,Town (Small),18,220,0.08181818181818182
796,St. Johnston,Donegal,54.93468,-7.461359999999999,90,0,0,0,410,76,576,0,Town (Small),90,410,0.21951219512195122
797,Stamullen,Meath,53.63023,-6.26834,614,4,10,202,3982,870,5682,0,Town (Small),816,3986,0.20471650777722028
798,Stoneyford,Kilkenny,52.5370387,-7.229316900000001,14,0,0,2,252,26,294,0,Town (Small),16,252,0.06349206349206349
799,Stradbally,Laois,53.01579830000001,-7.149471699999999,186,0,10,18,1126,200,1540,0,Town (Small),204,1126,0.1811722912966252
800,Stradbally,Waterford,52.1313569,-7.4608978,54,0,0,0,516,30,600,0,Town (Small),54,516,0.10465116279069768
801,Straffan,Kildare,53.3118851,-6.608824800000001,132,2,0,28,1148,260,1570,0,Town (Small),160,1150,0.1391304347826087
802,Strandhill,Sligo,54.26999009999999,-8.598940299999999,134,2,4,16,1956,318,2430,0,Town (Small),150,1958,0.07660878447395301
803,Stratford,Wicklow,52.9878852,-6.675076499999999,12,0,0,0,214,36,262,0,Town (Small),12,214,0.056074766355140186
804,Strokestown,Roscommon,53.7758666,-8.1035319,46,0,2,2,620,194,864,0,Town (Small),48,620,0.07741935483870968
805,Summerhill,Meath,53.4813655,-6.732514699999999,180,2,10,14,894,106,1206,0,Town (Small),194,896,0.21651785714285715
806,Suncroft,Kildare,53.1075785,-6.8613827,50,2,0,8,370,70,500,0,Town (Small),58,372,0.15591397849462366
807,Swanlinbar,Cavan,54.1937636,-7.7047113,24,0,6,0,114,94,238,0,Town (Small),24,114,0.21052631578947367
808,Swinford,Mayo,53.9437021,-8.950006,44,0,4,2,1068,386,1504,0,Town (Small),46,1068,0.04307116104868914
809,Swords,Dublin,53.4557467,-6.219740600000001,10364,282,90,422,32242,10730,54130,3,Town (Medium),10786,32524,0.3316320255811093
810,Taghmon,Wexford,52.3229838,-6.6546699,112,0,12,0,430,152,706,0,Town (Small),112,430,0.26046511627906976
811,Tagoat,Wexford,52.2454387,-6.388300099999999,88,0,2,2,508,56,656,0,Town (Small),90,508,0.17716535433070865
812,Tallanstown,Louth,53.9200662,-6.5471834,110,0,0,8,634,134,886,0,Town (Small),118,634,0.1861198738170347
813,Tallow,Waterford,52.09214069999999,-8.007030199999999,166,0,4,0,712,258,1140,0,Town (Small),166,712,0.23314606741573032
814,Tarbert,Kerry,52.5724738,-9.374537199999999,10,0,2,0,360,148,520,0,Town (Small),10,360,0.027777777777777776
815,Templemore,Tipperary,52.794802,-7.839860900000001,34,8,12,54,1582,620,2310,0,Town (Small),88,1590,0.055345911949685536
816,Templetuohy,Tipperary,52.78847,-7.721649999999999,24,0,0,0,212,40,276,0,Town (Small),24,212,0.11320754716981132
817,Termonbarry,Roscommon,53.7422919,-7.920643500000001,82,4,2,10,772,46,916,0,Town (Small),92,776,0.11855670103092783
818,Termonfeckin,Louth,53.76101389999999,-6.271843199999999,298,4,8,40,1942,198,2490,0,Town (Small),338,1946,0.1736896197327852
819,The Ballagh,Wexford,52.47257,-6.43323,62,0,6,0,574,50,692,0,Town (Small),62,574,0.10801393728222997
820,The Commons,Tipperary,52.6272156,-7.546653200000001,8,2,0,4,104,34,152,0,Town (Small),12,106,0.11320754716981132
821,The Swan,Laois,52.88901000000001,-7.160559999999999,48,0,0,4,270,32,354,0,Town (Small),52,270,0.1925925925925926
822,Thomastown,Kilkenny,52.5264574,-7.1383205,150,4,14,34,2110,590,2902,0,Town (Small),184,2114,0.08703878902554399
823,Three Mile House,Monaghan,54.21667,-7.042671299999999,22,0,2,0,130,20,174,0,Town (Small),22,130,0.16923076923076924
824,Thurles,Tipperary,52.6801064,-7.8044421,184,10,34,184,6750,2124,9286,0,Town (Small),368,6760,0.054437869822485205
825,Tievebane,Donegal,55.0630284,-7.429459,70,2,6,2,490,46,616,0,Town (Small),72,492,0.14634146341463414
826,Timoleague,Cork,51.6432296,-8.766188699999999,46,0,0,0,266,176,488,0,Town (Small),46,266,0.17293233082706766
827,Tinahely,Wicklow,52.7997634,-6.463184399999999,184,4,10,4,902,142,1246,0,Town (Small),188,906,0.20750551876379691
828,Tinryland,Carlow,52.7969671,-6.8957413,40,0,8,4,338,30,420,0,Town (Small),44,338,0.1301775147928994
829,Tinure,Louth,53.79188,-6.419,142,0,0,8,490,122,762,0,Town (Small),150,490,0.30612244897959184
830,Tipperary,Tipperary,52.47363910000001,-8.1617622,150,8,20,76,3982,1458,5694,0,Town (Small),226,3990,0.05664160401002506
831,Toomevara,Tipperary,52.85071629999999,-8.0350506,24,0,0,0,186,56,266,0,Town (Small),24,186,0.12903225806451613
832,Toornafulla,Limerick,52.36463999999999,-9.152849999999999,28,0,0,0,218,20,266,0,Town (Small),28,218,0.12844036697247707
833,Tower,Cork,51.92518,-8.60797,322,4,2,0,3950,148,4426,0,Town (Small),322,3954,0.08143651997976732
834,Tralee,Kerry,52.2713096,-9.6999325,1118,48,70,90,19390,6268,26984,3,Town (Medium),1208,19438,0.06214631134890421
835,Tramore,Waterford,52.16143539999999,-7.1492952,818,30,28,48,10600,2378,13902,0,Town (Small),866,10630,0.08146754468485419
836,Trim,Meath,53.5523666,-6.7866474,1174,18,30,46,8642,2302,12212,0,Town (Small),1220,8660,0.14087759815242495
837,Tuam,Galway,53.5141156,-8.8565177,670,22,34,14,8108,2162,11010,0,Town (Small),684,8130,0.08413284132841328
838,Tubbercurry,Sligo,54.0552258,-8.7298236,160,6,14,8,1916,410,2514,0,Town (Small),168,1922,0.08740894901144641
839,Tulla,Clare,52.8692148,-8.7607816,28,0,6,4,684,180,902,0,Town (Small),32,684,0.04678362573099415
840,Tullaghan,Leitrim,54.468449,-8.3290498,12,0,4,0,312,12,340,0,Town (Small),12,312,0.038461538461538464
841,Tullamore,Offaly,53.2752768,-7.4924439,1274,28,52,446,12244,3828,17872,3,Town (Medium),1720,12272,0.14015645371577576
842,Tullow,Carlow,52.802547,-6.7371517,278,0,20,16,4516,1304,6134,0,Town (Small),294,4516,0.06510186005314438
843,Tullyallen,Louth,53.73661,-6.42244,388,6,4,28,1674,370,2470,0,Town (Small),416,1680,0.24761904761904763
844,Tulsk,Roscommon,53.7799868,-8.2560526,22,0,2,4,184,20,232,0,Town (Small),26,184,0.14130434782608695
845,Turlough,Mayo,53.8841074,-9.2124764,36,0,2,0,572,8,618,0,Town (Small),36,572,0.06293706293706294
846,Turloughmore,Galway,53.3821288,-8.853684,30,0,2,0,298,4,334,0,Town (Small),30,298,0.10067114093959731
847,Two Mile House,Kildare,53.1702248,-6.700301899999999,76,0,2,22,522,80,702,0,Town (Small),98,522,0.18773946360153257
848,Twomileborris,Tipperary,52.6725745,-7.711432999999999,34,0,2,8,514,50,608,0,Town (Small),42,514,0.08171206225680934
849,Tyrrellspass,Westmeath,53.3889615,-7.3773447,42,0,2,2,306,74,426,0,Town (Small),44,306,0.1437908496732026
850,Unionhall,Cork,51.558803,-9.1434791,54,0,0,0,302,66,422,0,Town (Small),54,302,0.17880794701986755
851,Urlingford,Kilkenny,52.7205983,-7.5821799,120,2,10,12,876,312,1332,0,Town (Small),132,878,0.15034168564920272
852,Villierstown,Waterford,52.08824449999999,-7.850768,50,0,2,0,240,46,338,0,Town (Small),50,240,0.20833333333333334
853,Virginia,Cavan,53.8344096,-7.0813222,282,6,18,10,2730,878,3924,0,Town (Small),292,2736,0.1067251461988304
854,Walsh Island or Coolagary,Offaly,53.234638,-7.2138556,68,0,4,8,368,92,540,0,Town (Small),76,368,0.20652173913043478
855,Waterford city and suburbs,Waterford,52.2593197,-7.110070299999999,3786,284,186,182,48764,14232,67434,2,Town (Large),3968,49048,0.08090034252161148
856,Watergrasshill,Cork,52.0113682,-8.3440414,302,0,16,2,2004,456,2780,0,Town (Small),304,2004,0.15169660678642716
857,Waterville,Kerry,51.829465,-10.1745436,102,0,6,0,388,108,604,0,Town (Small),102,388,0.26288659793814434
858,Westport,Mayo,53.8011505,-9.5223,358,12,10,50,5124,2274,7828,0,Town (Small),408,5136,0.0794392523364486
859,Wexford,Wexford,52.336916,-6.4633381,980,52,66,82,17430,5748,24358,3,Town (Medium),1062,17482,0.06074819814666514
860,Whitechurch,Cork,51.9840023,-8.516469899999999,66,4,4,0,1048,12,1134,0,Town (Small),66,1052,0.06273764258555133
861,Whitegate,Clare,52.9505524,-8.3729064,18,0,2,0,172,8,200,0,Town (Small),18,172,0.10465116279069768
862,Whitegate,Cork,51.8267841,-8.2321121,234,2,4,10,1398,90,1738,0,Town (Small),244,1400,0.1742857142857143
863,Wicklow,Wicklow,52.9808207,-6.044588999999999,1070,38,40,464,11564,2834,16010,3,Town (Medium),1534,11602,0.13221858300293052
864,Williamstown,Galway,53.6777196,-8.579964,10,0,2,0,176,28,216,0,Town (Small),10,176,0.056818181818181816
865,Woodford,Galway,53.0521803,-8.4002368,2,0,4,0,244,26,276,0,Town (Small),2,244,0.00819672131147541
866,Youghal,Cork,51.9542704,-7.8471707,786,12,36,22,7088,1338,9282,0,Town (Small),808,7100,0.11380281690140845
